Как тебя зовут?	Дæ ном куыд хуыйны?
Меня зовут Алан.	Мæ ном хуыйны Алан.
Чей ты сын?	Кæй лæппу дæ?
Санаеа Ацамаза.	Санаты Ацæмæзы.
Где ты учишься?	Кæм ахуыр кæныс?
В пятьдесят седьмой школе города Владикавказ.	Дзæуджыхъæуы фæндзæм астæуккаг скъолайы.
В каком классе ты учишься?	Кæцы къласы ахуыр кæныс?
Я учусь в девятом классе.	Æз ахуыр кæнын фарæстæм къласы.
В какой класс ты ходишь?	Кæцы къласмæ цæуыс?
В девятый класс.	Фарæстæм къласмæ.
Чем ты занят?	Цæмæй кусыс?
Изучаю науку.	Наукон кусæгæй.
Где ты живешь?	Кæм цæрыс?
Во Владикавказе.	Дзæуджыхъæуы.
На какой улице ты живешь?	Кæцы уынгыл цæрыс?
Я живу на улице Гугкаева.	Æз цæрын Гугкайы-фырты уынгыл.
Сколько тебе лет?	Цал азы дыл цæуы?
Мне 15 лет.	Æхсæрдæс азы.
Кто не пришел сегодня в школу?	Чи не 'рбацыд абон скъоламæ?
Кого спросил учитель?	Кæй бафарста ахуыргæнæг?
Что говорит дежурный?	Цавæр дзуапп радта радгæс?
Где лежал Хетаг когда болел?	Кæм хуыссыд Хетæг рынчынæй?
Кто из детей знает адрес Хетага?	Сывæллæттæй чи зыдта Хетæджы адрис?
Кто дал учителю телефонный номер Хетага?	Чи радта ахуыргæнæгæн Хетæджы телефоны номыр?
Куда позвонил учитель?	Кæдæм бадзырдта ахуыргæнæг телефонæй?
Когда дети пошли проведать больного?	Кæд ацыдысты сывæллæттæ рынчынфæрсæг?
Кому был приятен приход детей?	Кæмæн уыд æхсызгон сывæллæтты æрбацыд?
Скоро моя сестра отправится учиться в Москву.	Тагъд рæстæджы мæ хо Мæскуымæ цæудзæн ахуыр кæнынмæ.
Учитель объясняет детям новый урок.	Ахуыргæнæг ахуыргæнинæгтæн амоны ног урок.
Я очень хочу учить зверей.	Мæн тынг фæнды сырдтæ ахуыр кæнын.
Мой отец вчера начал учить нашего двухлетнего жеребца.	Мæ фыд знон нæ дыууазыккон байраг райдыдта ахуыр кæнын.
Лиса уже привыкла к курятнику нашего соседа.	Рувас нæ сыхæгты кæркдонмæ фæцахуыр.
Я учусь в девятом классе 42 школы города Владикавказ.	Æз ахуыр кæнын фарæстæм къласы Дзæуджыхъæуы цыппор дыккæгæм скъолайы.
Нашу школу построили в 1976 году.	Мах скъола арæзт æрцыди мин фарастсæдæ æстай æхсæзæм азы.
В нашей школе много учеников.	Не 'скъолайы ис бирæ ахуыргæнинæгтæ.
На их учебу сильно влияют учителя.	Уыдоны ахуырыл тынг аудынц ахуыргæнджытæ.
В школе для каждого предмета есть свой кабинет.	Скъолайы алы предметæн дæр ис хицæн ахуырадон кълас.
Я очень люблю нашу школу.	Æз бирæ уарзын не 'скъола.
В каком классе я учусь?	Кæцы къласы ахуыр кæнын æз?
В какой школе я учусь?	Кæцы скъолайы ахуыр кæнын æз?
Когда построили нашу школу?	Кæд арæзт æрцыди мах скъола?
На чью учебу влияют учителя?	Кæй ахуырыл аудынц ахуыргæнджытæ?
Что есть у каждого предмета школы?	Скъолайы цы ис алы предметæн дæр?
Мы умеем переводить.	Мах тæлмац кæнын зонæм.
Ты перевел с нами ты предложения?	Ды нæма ратæлмац кодтай уыцы хъуыдыйæдтæ?
Из данных слов составьте предложение.	Лæвæрд дзырдтæй саразут хъуыдыйæдтæ.
Прочитайте и расскажите своими словами данный текст.	Бакæсут æмæ хи ныхæстæй радзурут лæвæрд текст.
Перепишите упражнение в тетрадь.	Фæлтæрæн рафыссут уæ тетрæдтæм.
Я учусь в университете.	Æз университеты ахуыр кæнын.
Я каждый день рано встаю.	Алы райсом дæр æз раджы фестын.
У нас возле дома есть автобусная остановка.	Нæ хæдзары цур ис автобусы æрлæууæн.
Наш учебный день заканчивается в 3 часа.	Нæ ахуыры рæстæг фæвæййы æртæ сахатыл.
Добрый день, Алан!	Дæ бон хорз, Алан!
Как дела?	Куыд дæ?
Все хорошо, спасибо.	Бузныг, ницы мын у.
Куда путь держишь?	Дæ фæндаг кæ-дæм дарыс?
На работу иду. А ты куда?	Куыстмæ цæуын. Ды та кæдæм цæуыс?
Я тоже на работу иду.	Æз дæр куыстмæ цæуын.
Где ты сейчас работаешь?	Кæм кусыс ныртæккæ?
В школе работаю, учителем.	Скъолайы кусын, ахуыргæнæгæй.
В какой школе работаешь?	Кæцы скъолайы кусыс?
В 45 школе, в городе.	Горæты 45-æм скъолайы.
Так пойдем вместе, я на заводе "Бином" работаю.	Уæдæ цом иумæ, æз та завод "Бином"-ы кусын.
Давно там работаешь? 	Рагæй кусыс уым?
Да, уже лет 5.	О, ныр иу фондз азы.
Кем на заводе рабоатешь, Алан.	Заводы та цæмæй кусыс, Алан?
Уже год главным инженером работаю.	Ныр иу афæдз сæйраг инженерæй кусын.
Доброе утро!	Уæ бон хорз!
Здравствуй!	Байрай!
Добрый день!	Дæ райсом хорз!
Счастье вашему дому!	Фарн уæ хæдзары!
Будь здоров!	Æнæнизтæ кæн!
Две матери, две девочки и бабушка с дочкой своего ребенка, всего их трое.	Дыууæ мады, дыууæ чызджы æмæ нана йæ хъæбулы чызгимæ, афтæмæй сты æртæ.
Трое? Нет, шесть!	Æртæ? Нæ, æхсæз!
Нет, их трое.	Нæ, сты æртæ.
Нет, их шесть!	Нæ, æхсæз!
Вы узнаете сколько им лет?	Сымах ма уæдæ базонут, цалæй сты?
Кто проходит по 30 километра в день?	Бон æртын километры чи цæуы?
Сколько километров проедет автомобиль за час?	Автомобил сахатмæ цал километры тындзы?
Во сколько прилетит самолет ТУ-104?	Цас рæстæгмæ стæхид Мæймæ хæдтæхæг ТУ-104?
Сколько пролетает спутник Земли за час?	Сахатмæ цал километры тæхы Зæххы æмзилдухгæнæг?
Кто хорошо учится, тот все знает.	Хорз чи ахуыр кæны, уый алцыдæр зоны.
Много чего он мне наговорил.	Алцыппæт ныхæстæ мын фæккодта.
Спроси меня, и я тебе обо всем расскажу.	Мæн бафæрс, æмæ дын алцыппæтдæр радзурдзынæн.
 Почему ты меня одного в тишине не можешь оставить?	Иууыл мæ æнцад цæуылнæ ныууадзыс?
Много чего я ему рассказал, но он все равно меня не послушал.	Бирæ йын фæдзырдтон, фæлæ мæм уый уæддæр нæ байхъуыста.
Два года спустя Зарина все равно пошла в медицинскую академию.	Дыууæ азы фæстæ Зæринæ уæддæр бацыд медицинон академимæ.
Быстрее быстрейшего была машина.	Тагъддæрæй тагъддæр уади машинæ.
Человек может знать все.	Адæймаг алцы зонынмæ бæллы.
Пожилые люди говорят что все в руках Всевышнего, но если человек сам ничего не делает, то ему даже Всевышний не поможет.	Зæронд адæм афтæ фæзæгъынц, æмæ, дам, алцыдæр Хуыцауы къухы ис, фæлæ адæймаг йæхæдæг куы ницы архайа, уæд ын Хуыцау дæр ницы феххуыс уыдзæн.
Это безусловно правильно.	Уый, æнæмæнг, раст у.
Сколько человек знает, столько он и живет.	Адæймаг куыд фылдæр зоны, афтæ фылдæр цæры.
К чему стремится человек?	Цæмæ тырны адæймаг?
Человек стремится к знаниям.	Адæймаг зонындзинæдтæм тырны.
Без знаний человек был бы как птица или скотина.	Æнæ зонындзинæдтæй адæймаг сырдтæ æмæ фосы хуызæн уыдаид.
Знания просто так  к человеку не приходят.	Зонындзинæдтæ адæймагмæ сæхæдæг не 'рцæуынц.
Чтобы много знать нужно много работать.	Бирæ зонынæн бирæ кусын хъæуы.
Много домов строит человек за всю жизнь.	Йæ цæрæнбонты адæймаг бирæ хæдзæрттæ саразы.
Знания собирались долгими эпохами.	Зонындзинæдтæ бирæ фæлтæртæ фембырд кодтой.
Во всякой работе нунжны знания.	Зонындзинæдтæ алы куысты дæр хъæуынц.
Без знаний человек не может жить.	Æнæ зонындзинæдтæй адæймаджы бон нал у цæрын.
Человек работает для того чтоб получить знания.	Адæймаг архайы уæддæр исты зонындзинæдтæ райсыныл.
Если у человека нет хоть каких-то знаний, то он и для общества ничто.	Адæймагмæ исты зонындзинад куы нæ уа, уæд æхсæнадæн дæр ницы пайда у.
Если бы не было знаний, то не было бы ни телевизоров, ни машин.	Зонындзинæдтæ куы нæ уыдаиккой, уæд нæ уыдаиккой телевизортæ дæр æмæ машинæтæ дæр.
Здравствуй, Бибо!	Байрай, Бибо!
Здравствуй, Кола!	Хорзæй байрай, Къола!
Куда ты пропал, не видно тебя нигде?	Кæм фесæфтæ, куы никуыцæйуал зыныс?
Не тут я был, Кола, недели три.	Ам нæ уыдтæн, Къола, иу æртæ къуырийы.
И не работал?	Æмæ кусгæ нæ кодтай?
Нет, я в отпуске был.	Нæ, æнцойуагъды уыдтæн.
И понравилось тебе?	Æмæ дзы дæ зæрдæмæ фæцыди?
Да, было очень хорошо, мне понравилось.	О, тынг хорз дзы уыди, мæ зæрдæмæ дзы фæцыди.
Приятно слышать, Бибо.	Уæдæ уый æхсызгон хабар у, Бибо.
Спасибо, Кола. А сам ты нигде не был?	Бузныг, Къола. Æмæ дæхæдæг та никуы уыдтæ?
Нет, я работал. У меня отпуск будет зимой.	Нæ, кусгæ кæнын. Мæнæн ме 'нцойуагъд зымæ-джы уыдзæн.
Зима тоже хорошее время чтоб отдохнуть. Поедешь куда-нибудь?	Зымæг дæр хорз рæстæг у фæллад суадзынæн. Æмæ искуыдæм цæудзынæ?
Да, я к нам в Цей поеду.	О, æз та нæхи Цъæймæ цæудзынæн.
О, это хорошее место чтоб провести там зимний отпуск.	О, уый хорз бынат у зымæджы фæллад уадзынæн.
Знаю, каждый год туда езжу.	Зонын æй, алы аз дæр уырдæм фæцæуын.
Я думаю в следующем году тоже там проведу отпуск.	Æз дæр, æвæццæгæн, иннæ аз уырдæм ацæудзынæн.
Ладно, Бибо, будь здоров!	Цæй, Бибо, дзæбæх уал у ныр та!
Ладно, Кола, тебе того же!	Цæй, Къола, дæ салам бирæ!
Где ты бываешь?	Кæм вæййыс?
Здесь не бываю.	Ам нæ вæййын.
Я отдыхал на берегу моря.	Мæ фæллад денджызы был уагътон.
Мне там понравилось.	Мæ зæрдæмæ дзы фæцыди.
Работаю.	Кусгæ кæнын.
Где ты отдыхал?	Дæ фæллад кæм уагътай?
Каждый год там бываешь?	Уырдæм фæцæуыс алы аз дæр?
А ты куда поедешь в следующем году?	Ды та кæдæм цæудзынæ иннæ аз?
Как говорят осетины.	Ирон адæммæ куыд фæзæгъынц?
Как живет Батырбег со своим соседом?	Батырбег куыд цæры йæ сыхагимæ?
Как всегда говорит Батырбег?	Батырбег æппынæдзух куыд фæзæгъы?
Заходи, Батырбег, посиди с нами!	Мидæмæ, Батырбег, абад немæ!
Как говорят осетинам?	Куыд фæзæгъынц ирон адæммæ?
Осетинам говорят так.	Ирон адæммæ афтæ фæзæгъынц.
Во всем мире нет человека без соседа.	Дунейыл æнæ сыхаг адæймаг нæй.
Человек встречает соседей раньше рассвета.	Хурыскастæй лæг йæ сыхæгтыл тагъддæр сæмбæлы.
Батырбег говорит так...  	Батырбег афтæ фæзæгъы...
Батырбег зашел внутрь...	Батырбег бахызт мидæмæ...
Кто посидит, тому счастье...	Чи абада, уымæн хæлар...
Завтра надо идти на работу.	Райсом мæ куыстмæ цæуын хъæуы.
Что ты сегодня делал, что случилось с тобой?	Абон цы кодтай, цы дыл æрцыди?
Мои друзья идут на работу, и мне надо их догнать.	Ме 'мбæлттæ куыстмæ фæцæуынц, æмæ мæ уыдон баййафын хъæуы.
Вечером когда работу закончишь, зайдешь к нам.	Изæрæй куыстæй куы суæгъд уай, уæд махыл рацæудзынæ.
После завтра мне надо пойти в лес.	Иннæ бон мæ хъæумæ ныууайын хъæуы.
С вечера до утра без перерыва шел снег.	Æхсæвæй бонмæ æнæрæнцайгæйæ мит фæуарыд.
Тебе идут твои туфли.	Дæ туфлитæ дыл хорз фидауынц.
Кто в этом году идет в школу?	Ацы аз скъоламæ чи цæудзæн?
В этом году в школу пойдет Ацамаз.	Ацы аз скъоламæ Ацæмæз цæудзæн.
Что родители купили Ацамазу?	Ныййарджытæ цы балхæдтой Ацæмæзæн?
Родители купили Ацамазу портфель.	Ацæмæзæн ныййарджытæ балхæдтой пъартфел.
Насколько я понял, тебе сегодня на учебу не нужно?	Æз дæ куыд бамбæрстон, афтæмæй ды ахуырмæ цæуинаг нæ дæ?
Показывайте мне как вы сделали домашнюю работу.	Йæ хæдзармæ куыст чи куыд сæххæст кодта, уый ма мын фенын кæнут.
Как сильно ты запачкал рубашку!	Цæй тынг чъизи ныккодтай дæ хæдон!
Ты бы знал как мне был приятен твой взгляд!	Дæ фенд мын куыд æхсызгон уыди, уый куы зонис!
Как закончатся экзамены, так сразу поеду в горы.	Экзаментæ куыддæр фæуой, афтæ хохмæ цæудзынæн.
Уметь бы петь как нарт.	Рагон нæртон лæгау зарын куы зонин.
Где я работаю? - я работаю на заводе "Электроцинк".	Кæм кусын æз? - æз кусын "Электроцинчы" заводы.
Сколько лет нашему заводу?	Цал азы цæуы нæ заводыл?
Откуда нашему заводу поставляют сырье?	Нæ заводмæ хомаг кæцæй ласынц?
Сколько людей в моей бригаде работает?	Мæ бригадæйы цал адæймаджы кусы?
Кто-нибудь из них опаздывает на работу?	Уыдонæй куыстмæ исчи байрæджы кæны?
Где мое рабочее место?	Мæ кусæн бынат кæцыран у?
Мое рабочее место бывает чистым?	Мæ кусæн бынат сыгъдæг вæййы?
Семья Туаева Володи живет во Владикавказе.	Туаты Валодяйы бинонтæ цæрынц Дзæуджы-хъæуы.
Мои предки бежали с горы Даргавса.	Мæ фыдæлтæ хохы Дæргъæвсæй ралидзгæ сты.
Мой отец родился в Санибе, а мама в Гизели.	Мæ фыд райгуырд Санибайы хъæуы, мæ мад та - Джызæлы.
Мои родители переехали в город лет 15 назад.	Мæ ныййарджытæ горæтмæ æрбалыгъдысты иу фынддæс азы размæ.
Изатбег давно уже не живет с родителями.	Изæтбег рагæй нал цæры йæ ныййарджытимæ.
Года два назад Цомаевы купили трехкомнатную квартиру в девятиэтажке.	Иу дыууæ азы размæ Цомайты бинонтæ райстой ног æртæуатон фатер фарастуæладзыгон хæдзары.
Дрис тоже должен купить квартиру в этом году.	Дрис дæр ацы аз хъуамæ райса ног фатер.
Какие города есть в Осетии?	Цавæр горæттæ ис Ирыстоны?
Столицей чего является Владикавказ?	Дзæуджыхъæу кæй сæйраг горæт у?
Что есть во Владикавказе?	Дзæуджыхъæуы цытæ ис?
Как добираются до работы жители Владикавказа?	Цæуыл фæцæуынц горæтæгтæ сæ куыстмæ?
Откуда пришли Осетины?	Кæцæй ралыгъдысты ирæттæ?
Откуда пришли жители города?	Горæты цæрджытæ кæцæй æрбалыгъдысты?
Куда они пришли с леса?	Быдыры хъæутæй кæдæм æрбалыгъдысты?
Для кого стал Владикавказ общим домом?	Дзæуджыхъæу иумæйаг хæдзар кæмæн сси?
Что замыслил Всевышний?	Хуыцау цы сфæнд кодта?
Какими были уадмеры?	Цавæр адæм уыдысты уадмеритæ?
Почему уадмеры не строили дома?	Уадмеритæ цæй тыххæй нæ арæзтой хæдзæрттæ?
Почему потерялись великаны?	Уæйгуыты чи фесæфта?
Уважаемый	Дæ хорзæхæй
Как твоя фамилия?	Дæ мыггаг кæмæй у?
Разрешите представить!	Базонгæ ут!
До свидания!	Хæрзбон!
Всего хорошего!	Дзæбæх ут!
Передайте привет!	Саламтæ раттут!
Благодарю вас за приглашение!	Дæ салам бирæ!
Не за что!	Ницы кæны!
Я познакомился с ним.	Æз базонгæ дæн йемæ.
Я знаю его	Æз æй зонын.
Я хочу с вами познакомиться.	Уемæ мæ фæнды базонгæ уын.
Сколько вам лет?	Цал азы дыл цæуы?
Приходи в десять часов.	Фараст сахатыл æрбацу.
Какая сегодня погода?	Боныхъæд абон цавæр у?
Сегодня будет дождь?	Абон уардзæн?
Какое сегодня число?	Абон кæцы бон у?
Какой сегодня день?	Цы бон у абон?
Вы говорите по-осетински?	Иронау дзурут?
Вы кого-то ищете?	Искæй агурут?
Девушка	Чызгай
Друг	Мæ лымæн
Брат	Ме 'фсымæр
Дорогой	Зынаргъ
Честь	Кад
Горе	Сар
Бег	Уад
Года	Аз
Когда	Кæд
Голова	Сæр
Тогда	Уæд
Я	Æз
Мальчик	Лæппу
Завтрак	Аходæн
Дорога	Фæндаг
Кот	Гæды
Кошка	Гæды
Мужчина	Лæг
Жадный	Кæрæф
Часы	Сахатмæ
Знать	Зонын
Стол	Стъол
Животное	Фос
Скот	Фос
Смотреть	Кæсын
Читать	Кæсын
Ум	Зонд
Знание	Зонд
Ты	Ды
Он	Уый
Она	Уый
Оно	Уый
Мы	Мах
Вы	Сымах
Они	Уыдон
Делать	Кæнын
Говорить	Дзурын
Работать	Кусын
Жить	Цæрын
Кушать	Хæрын
Чего ты смеёшься?	Цæуыл худыс?
Этот нож очень острый.	Ацы кард тынг цыргъ у.
У кошки девять жизней.	Гæдыйæн фараст царды ис.
Сегодня облачно.	Абон у асæст.
Он был вождём своего племени 35 лет.	Уый йæ знæмы раздзог уыдис 35 азы дæргъы.
Мне кажется, что она заболела.	Мæнмæ афтæ кæсы, æмæ фæрынчын и.
Он прекрасно говорит по-русски.	Уырыссагау иттæг хорз дзуры.
Завтра будет идти дождь?	Райсом уардзæн?
Где ближайшая аптека?	Хæстæгдæр афтек кæм ис?
Чья это книга?	Кæй чиныг у?
Её глаза смеются.	Йæ цæстытæ худынц.
Наконец пятница.	Æгайтма майрæмбон у.
Я электрик.	Æз дæн электрик.
Лиса и медведь жили вместе.	Рувас æмæ арс цардысты иумæ.
Отнесите его обратно.	Фæстæмæ йæ ахæссут.
Отнесите её обратно.	Фæстæмæ йæ ахæссут.
У каждой книги своя судьба.	Алы чиныгæн ис йæхи хъысмæт.
Когда начнётся состязание?	Ерыс кæд райдайдзæнис?
Мне нравится твоя машина.	Мæ зæрдæмæ цæуы дæ хæдтулгæ.
Слишком много болтаешь.	Æгæр бирæ дзæнгæда цæгъдыс.
Твои слова больно ранят.	Дæ ныхæстæ кардау цæвынц.
Когда он боролся с тобой, его сердце разрывалось пополам.	Демæ тох куы кодта, уæд йæ зæрдæ тъæппытæ хаудта.
Он испытывал боль и сострадание.	Уый æнкъардта рис æмæ тæригъæд.
Теперь я чувствую то же самое.	Ныр æз дæр уый æнкъарын.
Я рад, что всё кончилось именно так.	Æхсызгон мын у, хъуыддаг афтæ кæй фæцис.
Как бы мы ни противились этому — это факт.	Уый ныхмæ цасфæнды дæр лæууæм, уæддæр уый факт у.
У меня больше не болит голова.	Мæ сæр нал риссы.
Для всех народов были созданы школы, письменность, к ним пришли свет и образование.	Æппæт адæмтæн арæзт æрцыди скъолатæ, фыссынад, æрцыд сæм рухс æмæ ахуырад.
Школа работала и в военные годы, учителя вовремя получали зарплату.	Скъола куыста хæсты азты дæр, ахуыргæнджытæ афоныл истой сæ мызд.
Это странно.	Уый æнахуыр цыдæр у.
Я женщина.	Сылгоймаг дæн.
Я забыл его имя.	Йæ ном мæ ферох и.
Я забыл её имя.	Йæ ном мæ ферох и.
Я впервые был в Нью-Йорке.	Уыдтæн Нью-Йорчы фыццаг хатт.
У меня нет денег, но есть мечты.	Æхца мæм нæй, фæлæ мæм ис бæллицтæ.
Если хочешь хорошо изучить язык, изучи его сам.	Кæд дæ фæнды æвзаг хорз базонын, уæд дæхæдæг æй ахуыр кæн.
Слушай!	Байхъус!
Я объяснил ему это.	Уый йын бамбарын кодтон.
Мать несколько раз перечитала письмо сына.	Мад йæ фырты фыстæг цалдæр хатты фæкасти.
Всё получилось наоборот.	Алцыдæр зыгъуыммæ рауади.
Думаю, нам надо попробовать ещё раз.	Æнхъæлдæн, æмæ ногæй афæлварын нæ хъæуы.
Я вызвала полицию, как только увидела на полу его труп.	Йæ мард пъолыл куы федтон, уайтагъд пъæлицæмæ фæдзырдтон.
Мой отец поехал в Китай.	Мæ фыд ацыдис Китаймæ.
Куда он шёл?	Кæдæм цыдис?
Я не согласна.	Разы нæ дæн.
Я, как и вы, не спала в эти тяжёлые дни.	Æз дæр сымахау нæ фынæй кодтон уыцы уæззау бонты.
Я, как и вы, не спал в эти тяжёлые дни.	Æз дæр сымахау нæ фынæй кодтон уыцы уæззау бонты.
Кто-то позвонил.	Чидæр æрбадзырдта.
Сядьте, пожалуйста.	Сбад, дæ хорзæхæй.
Такого ты не видел даже во сне.	Уый ды дæ фыны дæр нæ федтай.
Такого ты не видела даже во сне.	Уый ды дæ фыны дæр нæ федтай.
Их было слишком много.	Æгæр бирæ уыдысты.
Их слишком много.	Æгæр бирæ сты.
Хорошо.	Хорз.
Хороший вопрос.	Хорз фарст.
Хорошая идея!	Хорз идейæ!
Очень хорошо.	Тынг хорз.
Хорошо. Прости.	Хорз. Хатыр.
Хорошо дома.	Нæхимæ хорз у.
Хороший мальчик.	Хорз лæппу.
Дорога хорошая?	Фæндаг хорз у?
Всё хорошо.	Алцыппæт у хорз.
Этот хороший.	Ай хорз у.
Еда хорошая.	Хæринаг хорз у.
Хорошее замечание.	Хорз фиппаинаг у.
Хорошее предложение.	Хорз хъуыдыйад у.
Жизнь хороша.	Цард у хорз.
Хочу хороший словарь.	Хорз дзырдуат мæ фæнды.
Эми — хорошая девочка.	Эми хорз чызг у.
Он хороший оратор.	Уый у хорз оратор.
Twitter недостаточно хорош.	Твиттер фаг хорз нæу.
Хорошо. Я согласен.	Хорз. Разы дæн.
Хорошо. А ты?	Хорз. Ды та?
Всё будет хорошо.	Алцыппæт уыдзæни хорз.
Я хороший таксист.	Дæн хорз таксист.
Очень хорошо, спасибо.	Тынг хорз, бузныг.
Том - хороший сосед.	Том хорз сыхаг у.
Он хороший врач.	Уый хорз дохтыр у.
Я хорошо вижу.	Уынын хорз.
Люди здесь хорошие.	Амы адæм хорз сты.
Это хорошая новость?	Хорз хабар у?
Руководство республики обсудило план принятия мер против кризиса.	Кризисы ныхмæ мадзæлттæ аразыны пъланыл ныхас кодта республикæйы разамынд.
Они восстали против врага.	Сыстадысты знаджы ныхмæ.
С праздником вас!	Бæрæгбоны хорзæх уæ уæд!
Она говорит по-русски.	Уый уырыссагау дзуры.
Я не согласен.	Разы нæ дæн.
Куда она шла?	Кæдæм цыдис?
Я из России.	Æз дæн Уæрæсейæ.
Это имя мне, к сожалению, незнакомо.	Ацы ном хъыгагæн нæ зонын.
Я работаю в Макдональдсе.	Ӕз кусын Макдонæльдсы.
Том хорош, но Мэри лучше.	Том хорз у, фæлæ Мэри хуыздæр.
Не ходите никуда один, ладно?	Никуыдæм ма ацу иунæгæй, хорз?
Вы можете мне его завернуть?	Уæ бон у мæнæн æй батухын?
Она проснулась на полу обнаженной.	Чызг пъолыл бæгънæгæй райхъал и.
Спеть вам песенку?	Азарон уын зарæг?
Что делать, не знаю.	Цы кæнон, нæ зонын.
Я совсем не понимаю его идеи.	Æз æппындæр не 'мбарын йæ идейæ.
Думаешь, у Тома хватит денег, чтобы это купить?	Куыд хъуыды кæныс, Томæн сфаг уызæн хса цæмæй ай балхæнын?
У Мэри всегда ухоженные ногти.	Мэрийæн алкæддæр йæ ныхтæ рæсугъд сты.
Я живу в Парме.	Æз цæрын Пармейы.
Я тоже был в Нью-Йорке.	Æз дæр уыдтæн Нью-Йоркы.
Я её не учу.	Æз æй нæ ахуыр кæнын.
Ты дурак!	Ды æдылы дæ!
Давненько я не виделся с Томом.	Томы рагæй нæ федтон.
"Вот моя книга". - "Это не твоя книга, это моя".	"Мæнæ мæ чиныг". -"Дæ чиныг нæу, мæн чиныг у".
Он мой дед?	Мæ дада у?
Вы знаете, когда зоопарк открывается?	Нæ зоныс сырдон кæд байгом уыдзæн?
Тому, похоже, не нравится играть в шахматы.	Том, мæнмæ гæсга, шахмадтæй хъазын нæ уарзы.
Ты можешь начать сегодня?	Дæ бон у абон райдайын?
Она говорит всё, что приходит в голову.	Уый дзуры алцыдæр йæ сæрмæ цы 'рцæуы уый.
Хочу ударить тебя в лицо.	Мæн фæнды дæ цæском ныццæвын.
Том намного старше меня.	Том мæнæй бирæ хистæрдæр у.
Я не могу сказать тебе, как это произошло.	Мæ бон нæу дæуæн зæгъын куыд рауайди уый.
Я подумал, что мы сможем остаться здесь на весь день.	Мæ хъуыдыты уыди, цæмæй на бон уыдзæн баззайын ам æнæхъæн бон.
Он отсутствует.	Уый ам нæй.
Мы хотим пойти прогуляться, но дождь льёт как из ведра.	Мах фæнды тезгъо канын, фæлæ хъæвда тынг уары.
Убери камеру.	Камерæ айс.
Мы вместе много сделали, но предстоит сделать ещё больше.	Иумæ бирæ скодтам, фæлæ бирæ фылдæр сканын хъæуы.
Не звоните сюда больше!	Мауал æрбадзур ардæм!
Том живёт здесь три года.	Том ам цæры æртæ азы.
Том не приходил?	Том не рцыди?
Расскажите нам всё, что знаете.	Радзурут нын алцыдæр цы зонут.
Мне сильно захотелось пить.	Æз тынг сфæнд кодтон дон баназын.
Хлопок — натуральная ткань.	Бæмбæг натурон хъуымац у.
Что бы ты сделал, если бы у тебя был миллион долларов?	Цы скодтаис милуан долларов дæм куы уыдаид уæд?
Наконец выход был найден.	Кæдæй-уæдæй рацыд уыди ссарын.
Она боялась собаки.	Уый кудзæй тæрскæ кода.
Он сказал мне, чтобы я попросил её.	Уый мын загъта цæмæй йæ æз бафæрсон.
Присмотрись.	Хуыздæр æм бакæс.
Даю тебе два дня на размышление.	Æз дын дæттын дыууæ боны ахъуыды кæнын.
Думаю, Том может тебе помочь.	Мæнмæ гæсгæ, Том дын баххуыс кæндзæн.
Когда хохол родился – еврей заплакал.	Хахойлаг куы райгуырди уæд дзуттаг бакуыдта.
Я поцеловал его в щёку.	Æз æй аба кодтон йæ русмæ.
Спасибо, что подождал меня.	Бузныг, цæмæй мæ æрбаталас кодтай.
Том поменял простыни на своей кровати.	Том баивдта прастина йæ сынтæгыл.
Не думал, что у тебя получится.	Нæ хъуыды кодтон цæмæй дын рауайдзæн.
Рассмотри факты.	Фактæ равзар.
С кем дрался Том?	Том хъæбысæй кæимæ хæцыди?
Она была моей первой любовью.	Уый уыди мæ фыццаг уарзондзинат.
Когда вы стали писать песни?	Кæд байдыдтай фыссын зарджытæ.
Я не хотел её будить.	Нæ мæ фæндыди йæ райхъал канын.
Том ест корм для кошек.	Том хæры гæдыты хæринаг.
Я не знаю, где именно нахожусь.	Ӕз нӕ зонын кӕм дӕн.
Как ты думаешь, что это?	Дӕумӕ гӕсгӕ цы у?
Покажи Тому журнал.	Томӕн журнал равдис.
Расскажи мне, что ты ел.	Радзур мын цы бахордтай уый.
Вы чьи?	Кæй стут?
Я любил их.	Ӕз цӕ уарзтон.
Мы подруги?	Мах ӕмбӕлдтӕ стӕм?
Я была расстроена.	Ӕз уыдтæн æнкъард.
Я никогда не прикасался к ней.	Ӕз ӕм никуы нӕ бавнӕлдтон.
Отель находится на горе.	Отель хохы цъуппыл ис.
Где ты раньше жил?	Раздæр цæргæ кæм кодтай?
Хочешь рыбы?	Кæсаг дæ хъæуы?
Он мне ещё понадобится.	Бахъæудзæн ма мын.
Комары меня любят.	Къогъотæ мæ уарзынц.
Из-за чего она погибла?	Цæй тыххæй амарди?
Отец ездит на работу на машине.	Папа фӕцӕуы куыстмӕ машинӕйыл.
Сегодня не так уж и жарко.	Абон ахӕм ӕнтӕф нӕу.
Обе его сестры красивы.	Йӕ дыууӕ хойы рӕсугъд сты.
Я хочу с тобой на пляж.	Мӕн фӕнды демӕ ацӕуын хинайӕнмӕ.
Том никогда не смеялся.	Том худгӕ никуы нӕ кодта.
Том играл на барабанах.	Том барабантыл хъазыди.
Вам нравится рок-н-ролл?	Рок-н-рол уарзут?
Я хочу MP3 плеер.	MP3 плеер мӕ хъӕуы.
У неё деньги есть?	Ис ӕм хса?
У меня есть большие дома.	Мӕнмӕ ис дынджыр хӕдзӕртӕ.
Это от Тома.	Ай Томӕй у.
Верни мне мою бутылку.	Мæ авг мын фæстæмæ рат.
Ты очень хороший повар.	Ды дæ тынг хорз пъовыр.
Я всё равно поеду.	Ӕз уæддæр ацæудзынæн.
Иногда да, иногда нет.	Кæддæр о, кæддæр на.
Где ты был вчера вечером?	Кæм уыдтæ знон изæрæй?
Кто хочет сыграть в теннис?	Кæй фæнды теннисæй ахъазын?
Сколько языков ты знаешь?	Цал æвзаджы зоныс?
Держи обе руки на руле.	Дæ дыууæ къухы дæр арæзнæгыл дар.
Он его нашёл.	Уый йæ ссардта.
"Она о тебе спрашивала". - "Обо мне?"	"Дæу тыххæй фæрскæ кодта." - "Мыл тыххæй?"
Я тогда здесь не работал.	Ӕз ам уӕд кускӕ нӕ кодтон.
Тебе завтра ко скольки?	Райсом кӕдмӕ цӕуыс?
Ей нужен ключ.	Дӕгъал ӕй хъӕуы.
Она не была бедна.	Мӕгуыр нӕ уыди.
Ты собрала свой чемодан?	Дӕ чемӕдан сымбырд кодтай?
Яблоки красные или зелёные.	Фæткъуытæ сырх æви цъæх сты?
Что ты думаешь о войне?	Дæ мæт хæсты тыххæй цавæр у.
Том не умрёт.	Том нæ амæлдзæн.
Я не смог её найти.	Мæ бон æй ссарын нæу.
Они были дома?	Сæхимæ уыдысты?
Я работаю в Милане.	Ӕз Миланы кусын.
Скажи нам, зачем ты его убил.	Зæгъ ма нын, цæмæн йæ амардтай.
Гроб был пуст.	Марды чырын афтид уыди.
Том и Мэри танцевали вместе.	Том æмæ Мэри иумæ кафыдысты.
Кен звонит мне каждый день.	Кен мæм дзуры алы бон.
Вчера мы школой посетили картинную галерею Прадо.	Знон мах шкъолаимæ ацыдыстæм Прадо нывты галерейæмæ.
Я работаю днём.	Æз кусын бонæй.
Солдат исполнял приказ командира.	Салдат къамандиры приказ æхæст кодта.
Он одноразовый.	Уый у иу хатт раз.
Я хотел бы ей позвонить. У тебя есть её номер телефона?	Мæн фæндыди йæм бадзурын. Йæ номыр дæм ис?
Чили - это не Китай.	Чили - Китай нæу.
Ты знаешь, кто это.	Ды нæ зоныс чи у?
Я сидел у себя в комнате и занимался.	Ӕз мæ агъуысты бадтæн æмæ кускæ кодтон.
Я пока не знаю, что буду говорить.	Æз нӕ зонын цы загъзынӕн уый.
Том никого из нас не узнал.	Том махӕй никӕйы нӕ базыдта.
Ты говоришь на воляпюке?	Воляпюкӕйыл дзурыс?
Не тревожьте меня сейчас.	Ныртæккæ мæм ма вналут.
Он жил здесь десять лет назад.	Уый ам царди дæс азы размæ.
Сколько стоит билет до Бостона?	Бостæнмæ билет цас кæны?
Она смотрела, как он ест.	Чызг кæска кодта, лаппу хæргæ куыд кодта уый.
Я беспокоюсь о здоровье Тома.	Ӕз Томы ӕнӕниздзинадыл тыхскӕ кӕнын.
Выбери букву алфавита.	Алфавиты дамгъӕ равзар.
Том купил три билета.	Том балхӕтта ӕртӕ билеты.
Том прихлопнул комара.	Том къогъойы амардта.
У тебя есть я.	Дӕумӕ дӕн ӕз.
Я знаю своё будущее.	Ӕз зонын мæ суинаг.
У меня есть только десять книг.	Мæнмæ ис æрмæстæр дæс чиныгы.
Я полагаю, что вы сидите на моём месте.	Мæнмæ гæсгæ ды мæ бынатыл бадгæ кæныс.
Дай мне фотографию Тома.	Томы къам ма мын æри.
Мэри красится.	Мэри рæсугъд у.
Когда ты возвращаешься в Бостон?	Бостæнмæ фæстæмæ кæд цæус?
Мои уши красные?	Мæ хъустæ сырx 'сты?
Он не ошибся.	Рæдыд не скодта.
Я знаю, что Том говорит правду.	Æз зонын цæмæй Том растдзинад дзуры.
Старый стул скрипнул под его весом.	Зæронд бандон йæ бынмæ ны къæс-къæс кодта.
Это дом, в котором он живет.	Ай у хæдзар кацыйы цæргæ кæны.
Лучше так!	Афтæ хуыздæр у!
Том сказал, что победит.	Том загъта цæмæй рамбулдзæн.
Том теперь бизнесмен.	Том ныр бизнесмен у.
Том опять выиграл?	Том ногӕй рамбылдта?
У меня есть лысина.	Мӕнмӕ гӕмӕх ис.
Я пью кофе после ужина.	Æз нуазын кофе изæры хæрыны фæстæ.
Могла бы и пораньше прийти.	Дæ бон уыди раздæр æрбацæуын.
Я ревнивая.	Æз дæн æхсайгæзæрдæ.
Мы с Томом работаем вместе.	Мах Томимæ иумæ кусæм.
Я буду здесь в понедельник.	Æз ам уыдзынæн къуырисæры.
Она ест, но мало.	Хæргæ кæны, фæлæ гыццыл.
Том - акробат.	Том акробат у.
Тридцати долларов достаточно?	Æртын доллар фаг у?
Я вас уничтожу.	Æз уæ ныммардзынæн.
Том был зол.	Том уыди маст.
Мэри приехала последней.	Мэри фæстаг æрбацыди.
Том рвёт цветы.	Том дидинджыта тоны.
Сколько ещё есть?	Цас ма ис?
Этот нож недостаточно острый.	Ацы кард хорз цыргъ нæу.
Моя левая рука не такая сильная.	Мæ галиу кьух ахæм тыхджын нæу.
Не спрашивай, кто я.	Ма мæ фæрс чи дæн.
Мэри её знает.	Мэри йæ зоны.
США — это республика.	США республикæ у.
Том — колдун.	Том кæлæнгæнæг у.
Том, Мэри, Джон и Элис пришли сюда вместе.	Том, Мэри, Джон æмæ Элис иумæ æрбацыдысты.
Их время ещё не пришло.	Сæ рæстæг нæма æрцыди.
Теперь уходите, пожалуйста.	Ныр, табуафси, ацæут.
Вы его знали?	Зонгæ йæ кодтат?
Я упустил свой шанс.	Ӕз мæ шанс ауахтон.
Он написал эту книгу в возрасте двадцати лет.	Уый ацы чиныг ныффысста дыууын азы йыл куы цыди уæд.
Том свой выбор сделал.	Том йæ æвзврæн скодта.
Найдите синонимы.	Синонимтæ ссарут.
Спускайся оттуда.	Уырдыгæй рахиз.
Мы рисуем животных.	Мах цæрæгойты ныв кæнæм.
Том художник?	Том нывгæнæг у?
Девочки плакали всю дорогу из школы домой.	Чызытæ æнæхьæн фæндаг скъолайæ сæхимæ кæугæ кодтой.
Где твой ресторан?	Дæ ресторан кæм и?
Не открывай его, пожалуйста.	Табуафси, ма йæ байгом кæн.
Том держал руку с пистолетом в кармане.	Том къух дамбацаимæ йæ дзыппы дардта.
Том всегда здесь.	Том алыкæддæр ам ис.
Он не умеет петь.	Уый зарын нæ зоны.
Том ест больше, чем я.	Том мæнæй фылдæр хæры.
Он боялся, что умрёт.	Тæрскæ кодта цæмæй амæлдзан.
Вы должны уйти.	Ды хъуамæ ацæуай.
Я люблю морковь.	Æз уазын уырыдзы.
Больше никто не придёт.	Ничиуал нæ æрбацæудзæн.
У него нет тени.	Аууон æм нæй.
Это дети Адама?	Ацы сывæллæттæ Адамы сты?
Это не свинья; это обезьяна.	Хуы нæу; маймули у.
Том пошёл не один.	Том иунæгæй нæ ацыди.
Я уже знаю, что думает Том.	Æз зонын Том цы хъуыды кæны уый.
Они спят.	Фынæй кæнынц.
Я ещё не поспал.	Фынæй нæма кодтон.
Том плакал как маленький.	Том сывæллоны хуызæн кæугæ кæны.
Том не знает, что ты сделал.	Том нæ зоны цы скодтай уый.
Сколько детей родилось?	Цал сывæлоны райгуырди?
Том летал.	Том тæхгæ кодта.
Я буду их учителем.	Æз сæ ахуыргæнæг уыдзынæн.
Том сказал мне, что он болен.	Том мын загъта цæмæй рынчын у.
Обе мои сестры - учителя.	Мæ дыууæ хойы ахуыргæнджытæ сты.
Я делаю попкорн. Хотите?	Æз попкорн кæнын. Хъæуы уæ?
Я хожу в летнюю школу.	Æз сæрды скъоламæ цæуын.
Это туман?	Ай мигъ у?
Это башня.	Ай мæсыг у.
Не знаю я никакого Тома.	Ницавæр Томы нæ зонын.
Я часто его тут вижу.	Æз æй ам арæх фенын.
Приведи её ко мне.	Мæнмæ йæ æрбакæ.
Прочти эту страницу.	Ацы сыф бакæс.
Ты видел мой фотоаппарат?	Ды мæ фотоаппарат нæ федтай?
Ты ничего не умеешь.	Ды ницы нæ зоныс кæнын.
Ты же вроде в кино собирался?	Ды киномæ нæ цыдтæ?
Напрасно ты ругаешься, мама!	Дзæгьæлы хыл кæныс, нана!
Том левша.	Том галиуæг у.
Сколько времени ты ехал сюда?	Цас рæстæг цыдтæ ардæм?
Том был вооружён ножом.	Том уыд хотыхифтонг кардæй.
Я думала, что поняла тебя.	Мæнмæ гæсгæ, бамбæрстон дæ.
Шоколад даже полезен.	Шиколад хайыргонд у.
Я знаю, что ты вернёшься.	Æз зонын цæмæй фæстæмæ æрбацæудзынæ.
Куда ты хочешь поехать этим летом?	Кæдæм дæ фæнды ацы сæрды ацæуын?
Его губы были бледны.	Йæ былтæ урс-урсид уыдысты.
Принесите мне его голову.	Йæ сæр мын æрбахæссут.
Я газет не читаю.	Æз газеттæ нæ кæсын.
Ну, как прошло?	Цæй цы, куыд уыди?
Ты знаешь, как это пишется?	Нæ зоныс куыд æй хъæуы ныффыссын?
Я не знал, что он ваш брат.	Æз нæ зыдтон ,уый де’фсымæр кæй у уый.
Он старше твоего отца!	Уый дæ фыдæй хистæр у!
Том часто ездит в командировки.	Том тынг арæх фæцæуы командировкæтæм.
Эта куртка мне мала.	Мæнæн ацы къурткæ гæр гыццыл у.
У Тома свой ресторан в Бостоне.	Томæн йæхи хæрæндон ис Бостоны.
Я сказал Тому, чтобы он не плавал слишком долго.	Æз Томæн загътон , цæмæй æгæр рæгмæ ма ленк кæна.
Том робкий.	Том нæуæндар у.
Супруги расстались, но дочь их воссоединила.	Бинойнæгтæ ахицæни сты, фæлæ с
В этом есть и твоя вина.	Уый дæ аххос дæр у.
Том строит новый дом.	Том амайы ног хæдзар.
Вот, берите.	Мæнæ, райсут.
Поэзия не должна быть логичной.	Поэзи логикæджын хъуамæ ма уа.
Как твоя поездка, Том?	Куыд у дæ балц, Том?
Ты это уже делал.	Да ай арæзтай.
Я надеюсь их увидеть.	Ныфс мæ ис уыдоны фенын.
Почему ты остался?	Ды цæмæ баззадтæ?
Том - игрок.	Том хъазæг у.
Том на строгой диете.	Том карз диетæйыл бады.
Том читал Мэри стихи при луне.	Том фарста Мэрийæн æмдзæвгæтæ мæйы рухсмæ.
Я их не критикую.	Æз уыдоны нæ критикæ кæнын.
Том застенчив.	Том æфсæрмдзæстыг у.
Преподаватель отвечает на все наши вопросы.	Ахуыргæнæг дзуапп дæтты нæ фарстатæн.
Мне не нужно сто голов, мне нужно двести рук.	Мæн нæ хъæуы сæдæ сæры, мæн хъæуы дыууæсæдæ къухы.
Я только замещающий учитель.	Æз æрмæст дæр хæдивæг ахуыргæнæг дæн.
Уверяю тебя, что я не нарочно.	Уырнын дæ кæнын , æз барæй нæ уыдтæн.
Все ждут?	Иууылдæр кæсынц æнхъæлмæ?
Покупаю.	Æлхæнын.
Видимо, деньги будут поделены поровну между ними двумя.	Æвæццæгæн æхца æмхуызон адих кæндзысты сæ дыууæйыл.
Мне нравится коллекционировать старые бутылки.	Мæнæн мæ зæрдæмæ цæуы зæронд æрдзытæ коллекци кæнын.
Ты чего такой буйный?	Цæмæн дæ ахæм нæрæмон?
Полночь.	Æмбисæхсæв.
Ты идёшь завтра в школу?	Сом цæудзынæ скъоламæ?
Это точно Том.	Ай æцæг дæр Том у.
Ты когда-нибудь ел мексиканскую пищу?	Ды искуы хордтай мексиканки хæринаг?
Это кукла.	Ай куклæ у.
Том болел.	Том рынцын уыдис.
Я ненавижу эту погоду.	Нæ уарзын ацы боныгъæд.
Ты бежишь.	Лидзгæ кодтай.
Вы боитесь?	Сымах тæрсут?
Ты слишком быстро идёшь.	Гæр тагъд цæуыс.
Выбери один из этих призов.	Ацы лæвæрдтай иу развар.
Вы решили эту загадку?	Ацы уыци-уыци райхæлдтат?
Том утверждал, что ему не заплатили.	Том дзырдта, кæй йын нæ бафыстой уый.
Он разве не был тебе другом?	Дæ æрдхорд куы уыдис?
Наш дом находится в конце следующей улицы.	Махæн нæ хæдзар иннæ уынджы кæрон ис.
Дети хотят слушать одну и ту же историю снова и снова.	Сывæллæтты фæнды æрмæст дæр иу истори мæ хъусын , ноджы æмæ ноджы
Кэн выучил много японских песен наизусть.	Кэн сахуыр кодта бирæ япойнаг зарджытæ зæрдывæрдæй.
Том отправился в путешествие.	Том ацыдис балцы.
Постарайся как следует.	Бацархай куыд æмбæлы афтæ.
Как ты думаешь, что я делал?	Куыд хъуыды кæныс, æз цы арæзтон?
Почему ты ведёшь себя так, будто не знаешь меня?	Дæхи афтæ цæмæ дарыс, цыма мæ нæ зоныс?
Вы идёте по улице.	Сымах уынгыл цæут.
Я сын Тома.	Æз Томы фырт дæн.
Мне отпустить Тома?	Ауадзон Томы?
Эти твои?	Адон дæу сты ?
Я ем фрукт.	Æз дыргъ хæрын.
Наши дела здесь закончены.	Нæ хъуыдтæгтæ ам фесты.
В автобусе она села рядом с ним.	Автобусы æрбадтис йæ цуры.
Я включил отопление.	Æз баиу кодтон тæвдгæнæн.
Отец махнул мне, чтобы я вышел из комнаты.	Мæ фыд мæм йæ къух атылдта, цæмæй годзейнæйæ рахизон.
Покажи.	Равдис
Не переключайтесь.	Ма ахицæн ут.
Пожалуйста, одолжи мне свой нож.	Дæ хорзæхæй, дæ кард ма мæм авæр.
Шум не прекратился.	Хъæлæба нæ банцадис.
Мы здесь, чтобы поговорить.	Мах ам уымæн стæм , цæмæй аныхас кæнæм.
Мне нельзя курицу.	Мæнæн нæй гæнæн карк.
Ты тупой?	Къуырма дæ?
Том сделал выбор.	Том сарæзта йа равзæрст.
Меня уже тошнит от чтения.	Мæ зæрдæ хæццæ кæны чиныг кæсынæй.
Простите, я нечаянно.	Бахатыр кæнут, барæй нæ уыдтæн.
Мы уходим.	Мах цæугæ кæнæм.
Я сегодня не могу пойти с тобой, потому что очень занят.	Мæ бон нæу абон де’мæ ацæуын , тынг æнæвдæлон дæн.
Только что я увидел лису, перебегающую дорогу.	Æз ен тæккæ рувасы федтон, фæндагыл алыгъдис.
Ты жив?	Удгас ма дæ?
Том, если ты не пойдёшь, то и я не пойду.	Том , ды куы нæ ацæуай, уæд æз дæр нæ цæуын.
Том не играет.	Том нæ къазы
Сейчас мой брат в Австралии.	Ерен ме фсымаер ис Австралияйы
Тебе бы уже пора домой.	Афон дын у хæдзармæ
Они простили меня.	Удон мын æй ныххатыр кодтой
Здесь?	Ам?
Я думаю, что он компетентен.	Ыз афтæ хъуыды кæнын, мæ йæ зоны
Придётся мириться, ничего не поделаешь.	Хъæуы бафидауын, ндæр гæнæн нæй
Я не готов идти.	Нæ дæн цæттæ цæуынмæ
Как вы вообще там оказались, да ещё в такое время?	Уым куыд вевзæрдыстут, гæр стæмæй ацафон?
Что должно быть в аптечке первой помощи?	Цы хъомæ уа фыццаг ххуысты аптечкæйы?
Передайте ему, пожалуйста, чтобы он мне перезвонил.	Зæгъ ма йын табуафси, цæмæй мæм радзура
Посветите сюда.	Ардæм ма рбарухс кæн
Я больше люблю жару, чем холод.	ыз фылдæр уарзын хъарм, уазалæй
Том стоит на обочине шоссе и голосует всем проезжающим легковушкам, но никто не останавливается.	Том лæууы фæндагы фарс мæ хъæлæс кæны йæ цуры цæуæг машинатæм, фæлæ ничи лæууы
Это была задача невероятной трудности.	Ацы хæс уыди тынг зын
Она ходит бесшумно.	Уый фæцæуы æнæ уынæрæй.
Мы только вчера получили Ваше письмо.	Мах æрмæстæр знон райстам дæ писмо.
Опять осень.	Фæззæг та ногæй.
Давай скорей! Автобус идёт!	Тагъддæр! Автобус æрбацæуы!
От твоих ног идет неприятный запах.	Дæ къæхтæй æвзæр тæф цæуы.
Почитайте это.	Мæнæ ма ай бакæс.
Ты можешь не отвечать, если не хочешь.	Дæ бон у мæ мын дзуапп ма радтай, кæд дæ нæ фæнды уæд.
Я забыл покормить свою собаку.	Фе’рох мæ ис мæ куыдзæн хæринаг радтын .
А вам всем спать, что ли, не хочется?	Мæ сымахмæ фынæй нæ цæуы?
Одна из девушек осталась позади.	Чызджытæй иу фæстейæ баззадис.
Не будь робким.	Нæуæндаг ма у.
Будьте благоразумны.	Æмбаргæ дæр ут.
Твоя собака там.	Дæ куыдз уым и.
Я не буду носить это платье.	Æз нæ дардзынæн ацы къаба.
В самом деле?	Æцæгæй?
Я с ним знаком, но имени его не знаю.	Мæ зонгæ у, фæлæ йæ ном нæ зонын.
Мы видели, как Том плачет.	Мах федтам Том кæугæ куыд кæны уый.
Мы все тебя любим.	Мах дæ уарзæм.
Я часто её тут вижу.	Æз æй ам арæх фенын.
Мои мать и отец родились в Бостоне.	Мæ мад æмæ мæ фыд Бостоны райгуырдысты.
Где жила Мэри, когда была ребёнком?	Кæм царди Мэри сывæллон куы уыди уæд?
Том работает в Бостоне.	Том Бостæны кусы.
Вы знаете, куда Том идёт?	Нæ зонут, кæдæм цæуы Том?
Вы можете быстро бегать?	Дæ бон у тагъд лидзын?
У Тома нет ни одного ребёнка.	Томæн иунæг сывæллон дæр нæй.
Когда состоится её свадьба?	Йæ чындзæхсæв кæд уыдзæн?
Том — отец невесты.	Том усагы фыд у.
Том написал своё имя.	Том йæ ном ныффыста.
Зелёный такой есть?	Ахæм цъæхæй ис?
Мне двенадцать.	Мæнæн дыууадæс азы у.
Он весь день плакал.	Уый æнæхъæн бон кæугæ кодта.
Он её боится.	Тæрскæ йæ кæны.
Я не люблю сырую рыбу.	Æз нæ уарзын хом кæсаг.
Вы его не видели.	Нæ йæ федтат?
Он сел в машину.	Машинæйы сбадти.
Том ездил с вами в Бостон?	Том смахимм Бостонмæ цыди?
Том строит домик из спичек.	Том спичкæтæй хæдзар аразы.
Я знаю, что вы едите.	Æз зонын цы хæрут уый.
Я не люблю грибы.	Æз къозотæ нæ уарзын.
Я проснулся в четыре.	Æз цыппар сахатыл райхъал дæн.
Мы домой.	Мах нæхимæ.
Она рано приходит.	Чызг раджы æрбацæуы.
Можешь съесть.	Дæ бон у бахæрын.
Том продолжал задавать мне вопросы.	Том адарддæр кодта йæ фарстатæ дæдтын.
Я сварю тебе бобы.	Æз дын афыцынæн сойæтæ.
Я перекусил.	Æз ацаходын кодтон.
Мы с Томом побежали.	Томимæ алыгъдыстæм.
Том прочитал это вслух.	Том хъæрæй бакастис.
Том ест?	Том хæргæ кæны?
Том хотел поужинать в постели.	Томы фæндыдис æхсæвæр бахæрын хуыссæнуатыл.
То, что он говорил, оказывалось ложью.	уый цы та дзырдта,уыдон раст нæ уыдысты.
Том поехал.	Том ацыдис.
Да?	Ойы?
Спасибо, что пришли встретить меня.	Бузныг ,кæй рацыдыстут мæ размæ.
Том купил камеру, чтобы подарить её Мэри.	Том камерæ балхæдта, цæмæй йæ Мэрийæн балæвар кæна.
Я умираю?	Æз мæлгæ кæнын?
Я хотел купить книгу, чтобы читать в самолёте.	Мæн фæндыдис чиныг балхæнын , цæмæй йæ хæдтæхæгыл кæсон.
Она была очень удивлена, когда услышала эту новость.	Тынг дис кодта , куы фе'хъуыста уыцы хабæрттæ, уæд.
Мне немного помогли.	Мæнæн гыццыл аххуыс кодтой.
Я переел.	Фе'алгъæд дæн.
Как эта дорожная авария произошла?	Куыд æрцыдис уыцы фæндаггаг авари?
Я с Томом.	Æз Томимæ дæн.
Когда Том был подростком, он любил писать стихи.	Том æнахъом куы уыдис, уæд æмдзæвгæтæ фыста.
Я уже знаю.	Æз зонын.
Как долго будет эта холодная погода длиться?	Кæдмæ ма уыдзæнис ацы уазал боныгъæд?
Тебе звонил Том.	Том дæм дзырдта.
Где ты впервые встретил её?	Кæм æй федтай фыццыг хатт?
Мой сын слепой.	Мæ лæппу куырм у
Приехали.	Æрбацыдысты.
Под столом лежит корзина.	Столы бын ис къалати.
Я вернулась.	Æз фæстæмæ æрбацыдтæн.
Я не ворую.	Æз давгæ нæ кæнын.
Том забывчив.	Том рохгæнаг у.
Ты когда-нибудь ел помидоры с сахаром?	Искуы хордтай помидор сæкæримæ?
Что Вы сказали?	Цы загътат?
Я пришёл извиниться.	Æз æрбацыдтæн хатыр курынмæ.
Том - красавец.	Том-рæсугъд лæппу у.
Я совершенно счастлив.	Æз бынтон амондджын дæн.
Слушайте.	Хъусут.
Работает?	Кусут?
Уже 11 часов.	Иууæндæс сахат у.
Ты уверена, что не хочешь сегодня вечером прийти?	Ныфс дæ ис, æмæ изæры не рбацæудзæ?
Что вы едите? Пахнет очень вкусно.	Цы хæрут ? Тынг адджын тæф кæны.
Разве так честно?	Мыййаг афтæ раст у?
Они идут сюда.	Уыдон цæуынц ардæм.
Заказываем?	Заказ кæнæм?
Было темно.	Талынг уыдис.
Не устал?	Нæбафæладтæ?
Нам нужен холодильник побольше.	Мах хъæуы фылдæр уазалгæнæг.
Что я должен изменить?	Цы хъомæ фæивон?
Почему ты так хорошо говоришь по-английски?	Цæмæ дзурыс англисаг æвзагыл автæ дзæбæх.?
Так приятно наконец познакомиться с Вами!	Тынг æхсызгон мын у сымахимæ базонгæ кæнын.
Родители Тома из Австралии.	Томæ йе рвад сты Австралияйæ
Садись сюда.	Ам æрбад.
Посторонись!	Иуварс!
В апреле мы поедем в Лондон.	Хымгæнæны мæйы цæуæм Лодонмæ
Жить не легко.	Цæрын æнцон нæу.
Это книга.	Чиныг.
Если смогу, завтра тоже приду.	Кæд мæ бон суыдзæнис , уæд сом дæр æрбацæудзынæн.
Где ты был?	Кæм уыдтæ?
Кому ты написал письмо?	Кæмæн ныффыстæй писмо?
Ты как, Том, сильно проголодался?	Куыд дæ , Том, тынг стонг дæ?
Не упрекай себя.	Дæхи ма æфхæр.
Замолчите!	Банцайут!
Поезжайте без меня.	Æнæ мæн ацыт.
Теплее.	Хъарм дæр у.
У меня не получилось.	Нæ мын рауадис.
Можешь идти.	Дæ бон у мæ ацæуай.
Том ушёл.	Том ацыдис.
Я нечасто улыбаюсь.	Ыз арæх нæ худын
Когда?	Кæд?
Сколько цветов в вазе?	Цас дидинджытæ ис вазæйы?
Отвечать?	Дзуапп дæттын?
Откуда вы?	Кæцæй стут?
Вы спали.	Фынæй кодтат.
Он собрал свои книги.	Æртымбыл кодта йæ чингуытæ.
Не подпускай их к себе.	Дæхимæ сæ æвахс ма уадз.
Мне нужно покормить кота.	Мæ гæдыйæн мын хæринаг раттын хъæуы.
Том, вероятно, знает ответ.	Том æвæццæгæн зоны раст дзуапп.
Почему он не возвращается?	Фæстæмæ цæмæнæ здæхы?
Сами обвинил Лейлу в том, что она бросила в его окно кирпич.	Сæхæдæг Лейлæйы аххосджын фæкодтой , йæ рудзынгыл агуыридур кæй фæкодта уый тыххæй.
Как зовут вашу кошку?	Уæ гæдыйы ном куыд хуыйны?
Том не спешит продавать свой автомобиль.	Том йæ машинæ уæй кæнын мæ нæ тагъд кæны.
Вы Тома даже не знаете.	Сымах Томы зонгæ дæр нæ кæнут.
Завтра я буду дома.	Сом хæдзары уыдзынæн.
У меня есть время в понедельник.	Къуырисæры мын ис рæстæг.
Я сегодня свободен.	Æз абон сæрибар дæн.
У Тома достаточно денег, чтобы купить всё, что ему хочется.	Том мæ фаг æхца ис , цæмæй балхæна цы йæ хъаеуы уый.
Меня никто не найдёт.	Мæн ничи не’ссардзæн.
Это вражеская страна.	Знаджы бæстæ.
Я дома каждый вечер.	Æз алы изæр дæр хæдзары вæййын.
Я приготовил для них ужин.	Æз уын æхсæвæр рцæдтæ кодтон.
Поторапливайся!	Фæтагъд кæн!
Наконец!	Кæдæй-уæдæй!
Пошли.	Ацыдыстæм.
Класс!	Кълас.
Жалко.	Æвгъау.
Ой...	Уой.
Вставай.	Слæуу.
Выкладывай.	Радзур.
Начинайте!	Райдаут!
Да.	Ойы.
Нет.	Нæйы.
Увидим.	Фендзыстæм.
Спите?	Фынæй кæнут?
Начали!	Райдыдтам!
Отдохнём.	Баулæфæм.
Отлично!	Тынг хорз.
Бывает.	Вæййы.
Смешно!	Худæг!
Весна.	Уалдзæг.
Тоска.	Мысын.
Легко.	Æнцон.
Идиот!	Сæрхъæн.
Почему?	Цæмæ?
Оставь!	Ныууадз !
Умри!	Амæл!
Почти.	Зæгъæн ис.
Чёрт!	Хæйрæг!
Быстрей!	Тагъддæр!
Мне бы очень хотелось поехать туда с вами.	Мæн тынг фæнды ,цæмæй уырдæм сымахимæ ацæуон.
Неправильно!	Раст нæу!
Том ничего не понимал.	Том ницы æмбæрста.
Дождь длился четыре дня.	Цыппар бон къæвдатæ уыдис.
Том хочет, чтобы я попросил прощения.	Томы фæнды, цæмæй дзы хатыртæ ракурон.
Ты наелся?	Бафсæсдтæ?
Что ещё Тому нужно сделать?	Томæн ма цы хъæуы саразын?
Потрачено!	Бахардз ис!
Берегись.	Дæхи хъахъхъæн.
Прощайтесь.	Хæрзбон зæгъут.
Постой!	Фæлæу!
Постойте!	Фæлæут!
Проголодались?	Сыстонг стут ?
Трепет...	Рызт.
Поправляйся.	Дзæбæх кæн.
Помалкивай.	Дæ дзыхыл хæц.
Помалкивайте.	Уæ дзыхтыл хæцут.
Выезжаю!	Фæцæуын!
Смелее!	Хъæбатыр дæр у!
Проклятие!	Æлгъыст!
Запевай!	Зарын райдайут!
Отпусти!	Ауадз.
Ступайте.	Ацæут.
Соскучился?	Рымысыдтæ?
Спс!	Бузныг!
Крыса!	Уыры !
Сколько лет ты училась в университете?	Цал азы университеты ахуыр кодтай?
Что нам Том дал?	Цы нын радта Том?
Мне кажется, это его машина.	Мæнмæ гæсгæ ай йæ машинæ у.
Где он купил это пальто?	Кæм балхæдта ацы пальто?
Перерыв!	Фæурæд.
Догоняй!	Æййафмæ!
Догоняйте!	Æййафутмæ!
Стыдно?	Худинаг у?
Когда ужин?	Æхсæвæр кæд у?
Кто у вас адвокат?	Адвокат уын чи у ?
Мы много времени тратим зря.	Бирæ рæстæг дзæгъæлы сафæм .
Я ничего не говорила.	Æз ницы дзырдтон.
Том очень расстроится, когда узнает, что произошло.	Томæн тынг хъыг уыдзæнис, куы йæ базона цы рцыдис уый.
Ты знаешь, какого цвета у Тома машина?	Зоныс Томæн йæ машинæ цы хуызон у?
Я рад, что могу вам помочь.	Тынг æхсызгон мын у , мæ бон уын кæй баххуыс кæнын уый .
Мне приснилась Татоэба.	Фыны Татоэбæйы федтон.
Удивительно, что ты меня помнишь.	Диссаг, кæй мæ хъуыды кæныс.
Вам нужны друзья.	Сымах хъæуы æмгæрдтæ.
Ты всё делаешь мне назло.	Ды мæнæн алцыдæр фыдæнæн аразыс.
Давайте разделим деньги!	Цæйут адих кæнæм хцатæ!
Я немного ревную.	Гыццыл мæ зæрдæ хсайы.
Ты выздоровела.	Адзæбæх дæ.
Нам следует читать как можно больше книг.	Махæн хъæуы фылдæр чингуытæ кæсын.
Я толстая.	Æз тыппыр дæн.
Я ничуть не устал.	Æз иу гыццыл дæр нæ бафæладтæн.
Одевайтесь!	Уæ дзаумæтæ скæнут
Расскажи мне, что ты знаешь о ситуации.	Радзур ма мын , цы зоныс уыцы хабары тыххæй.
Держите.	Хæцут.
Я в этом силён.	Æз уым тыхджын дæн.
Кто для тебя Том?	Том дын чи у ?
Перейди мост.	Хидæй ахиз.
Забудь об этом!	Фе’рохæй кæн!
Дело не в том, что ты носишь, а как ты это носишь.	Хъуыддаг уый мидæг нæй , цы дарыс , фæлæ йæ куыд дарыс.
Рано или поздно Том это поймёт.	Раджы æви рæгмæ Том бамбардзæнис.
Рано.	Раджы.
Посмотри назад.	Фæстæмæ акæс.
Ты до скольких лет верил в Деда Мороза?	Цал аз мæ дæ уырныдта Митын Дада ?
Пожалуйста, подождите немного.	Табуафси, гыццыл ма фæлæуут.
Завтра мой папа приготовит вкусную еду.	Сом мæ фыд æрцæттæ кæндзæнис адджын хæринаг.
Я регулярно бегаю в парке.	Æз уысмæн фæлидзын паркмæ.
Я был удивлён этим.	Мæнмæ диссаг фæкастис.
Она всегда ссорилась со своими братьями.	Уый алы хатт дæр йе’фсымæртимæ хыл кодта.
Давайте говорить по-французски.	Цæйут дзурæм французаг æвзагыл.
Я трезв.	Æз æвронг дæн.
Он был одет в синее.	Арвхуыз дзаумæдтæ йыл уыдис.
Где они?	Кæм сты ?
Вы молоды.	Сымах нæма æвзонг стут.
У меня было много веселья в Австралии.	Бирæ хъæлдзæг дзинæдтæ мын уыдис Австралийы.
Том не зол.	Том мæсты нæу.
Могу я говорить по-французски?	Мæ бон у французаг æвзагыл дзурын?
Том и Мэри часто звонят друг другу.	Том æмæ Мэри кæрæзимæ арæх дзурынц.
Шутишь!	Хъынджылæг кæныс!
Мне действительно нужен отпуск.	Мæн æцæгæй дæр хъæуы отпуск .
Он получил довольно много писем этим утром.	Ацы райсомæй йæм æрбацыд бирæ фыстæджытæ.
Ты должен прибыть в школу до восьми.	Скъоламæ аст сахатмæ хъуамæ æрбацæуай.
Выходите!	Рахизут!
Вы помните Тома?	Томы хъуыды кæнут ?
Сюда!	Ардæм!
Том не хочет иметь ресторан.	Томы нæ фæнды, цæмæй йын хæрæндон уа.
После ужина мы вышли на прогулку.	Æхсæвæры фæстæ рацыдыстæм тезгъо кæнын мæ.
У тебя ещё есть вопросы?	Исты фарстатæ ма дæм ис ?
Мы с Томом ушли пораньше.	Мах Томимæ раздæр ацыдыстæм.
Следующая очередь ваша.	Дарддæр уæ рад уыдзæнис.
Том всё утро провёл с Мэри.	Том нæхъæн райсон арвыста Мэриимæ.
Вам надо было раньше прийти.	Сымах раздæр хъуыдис æрбацæуын.
Не лги мне.	Ма мæ сай.
Мы доберёмся туда вовремя.	Афоныл бахæццæ уыдзыстæм .
Все пришли на вечеринку, кроме Тома.	Иууылдæр æрбацыдысты хъазтизæрмæ ,Том йеддæмæ.
Том лжет.	Том сайгæ кæны .
Это ваш карандаш?	Ай сымах кърандас у?
Я ищу Нацуко.	Æз Нацукойы агурын.
Он передал деньги продавцу.	Хца радта уæйгæнæгмæ.
Том вялый.	Том лæмæгъ у .
Она скрывает от нас правду.	Растдзинад нæ æмбæхсы.
Всё ясно?	Алцыдæр бæрæг у ?
Где газета?	Кæм ис газет ?
В следующий раз я приду вместе с сестрой.	Иннæ хатт мæ хоимæ æрбацæудзынæн.
Приходите послезавтра, пожалуйста.	Табуафси, иннæбон иу æрбацæут .
Пошли есть.	Цом хæрынмæ.
Том хорошо работает.	Том дзæбæх кусы.
Ты можешь отпустить Тома.	Дæ бон у мæ Томы ауадзай.
Это ваше?	Сымах у?
Том врёт?	Том сайгæ кæны ?
Воду, пожалуйста.	Дон , табуафси.
Если играешь, то выиграешь.	Кæд хъазыс, уæд рамбулджæ
Мэри моя.	Мэри мæн у.
Испугался?	Фæтарсттæ?
Ты позвал Тома?	Томмæ фæдзырдтай?
Не спрашивайте меня о ней, пожалуйста.	Табуафси, ма мæ фæрсут умæй
Ты умный.	Зæнджын дæ.
Пожалуйста, выйдите из моей машины.	Табуафси, машинайæ ахизут
Мы с Томом согласны.	Æз æмæ Том разы стæм .
Сколько стоит эта рубашка?	Ацы хæдон цас кæны ?
Том не любит сидеть дома.	Том нæ уарзы хæдзары бадын.
Японский язык сложный, но не настолько, как китайский.	Япойнаг взаг зын у, фæлæ китайаг зындæр у
Она его так любила.	Тынг æй уарзта
Они не хотят, чтобы вы знали.	Уыдоны нæ фæнды, шæмæй йæ сымах зонæт
Я боюсь темноты.	Ыз тæрсын талынгæй
Если я ошибаюсь, поправьте меня.	Кæд фӕрӕдийын уæд мæ бараст кæнут
Я не умею читать.	Ыз нæ зонын фæрсын
Том не виноват в том, что случилось.	Цы хабар ӕрцыд ум Томы аххос нæй
Мы лежим на траве.	Мæх хуыссам кæрдæгыл
Прочтешь эту книгу, положи её на прежнее место.	Куы бæфæрсай ацы чиныг, уæдай ӕрӕвӕр ейæ бынаты
Даже если бы Том нас увидел, он бы ничего не сказал.	Том нæ куы федтаит уæддæр ницы загътаит
Многие алжирцы живут и работают во Франции.	Бирӕтӕ алжирецтæ цæрынц æмæ кусынц Францийæ
Она оставила окно открытым.	Ныууагъта рудзынг гомæй
Том продолжает писать.	Том уӕд дӕр фыссы
Том больше не курит.	Том тамако нæл дымæ
Какую одежду ты обычно носишь?	Цыхуызæн дзаумӕттӕ дарыс
Могу я воспользоваться телефоном?	Мæ бон у мæ дæ телефонæй спайда кæнон?
Садитесь!	Æрбадут!
Мы даже не знаем, что это.	Нæдæрæй зонæм цы у
Том с вами?	Том сымахимæ ис ?
Том и Мэри не любят меня.	Том æмæ Мэри нæ уарзынц мæн.
Вытри руки этим полотенцем.	Дæ къухтæ ацы хисæрфæнæй нысæрф.
Дайте мне те перчатки.	Раттут мын уыцы армкъухтæ
Я победил!	Æз рамбылдтон!
Я уже ничего не понимаю.	Ыз ницыуæл æмбæрын
Вы жалуетесь и жалуетесь на боль в спине, но никогда не идёте к врачу.	Сымах уæ астæуы рыстæй хъаст кæнут ,фæлæ дохтуртæм нæ цæут.
Я сказал Мэри, что хочу быть просто другом.	Æз загътон Мэрийæ кæй мæ фæнды , цæмæй æмбæлдтæ уæм.
Как ты думаешь, я похож на Тома?	Куыд хъуыды кæныс , Томы хуызон дæн?
Вы выбрали плохое время.	Сымах равзæрстат æвзæр рæстæг
Я стою.	Æз лæууын.
Это японская кухня?	Ай япойнаг кухнæ у ?
Иду.	Фæцæуын.
Я посчитал деньги.	Ыз банымæттон æхца
У Тома слишком богатое воображение.	Томæн хъæхъыг фæлгæнæн ис.
Том сел за пианино и начал играть.	Том æрбадти пианинæйы раз æмæ райдыдта хъазын.
Приготовьтесь к эвакуации.	Уæхи рцæттæ кæнут эвакуацимæ.
Я не забыла.	Нæ мæ ферох ис .
Это ваше письмо?	Ай сымах фыстæг у?
Есть новости?	Исты хабæрттæ ис ?
Я выбрала.	Æз равзæрстон.
Ты идёшь на свадьбу Тома и Мэри?	Цæуыс Том æмæ Мэрийы чындзæхсæвмæ?
Я буду очень рад, если вы мне поможете.	Тынг æхсызгон мын уыдзæнис, кæд мын баххуыс кæнат уæд .
Ты не знаешь, чьё это?	Нæ зоныс , ай кæй у ?
Просто скажи мне, что ты знаешь о Томе.	Зæгъ ма мын , цы зоныс Томы тыххæй.
Чей ход?	Кæй цыд у?
Кто в доме?	Хæдзары чи ис?
Я услышал эту новость случайно.	Æз уыцы хабар æнæнхъæлæджы фехъуыстон.
Он запел.	Нызарыдис.
Я решил посетить Бостон.	Æз сфæнд кодтон Бостоныл азилын.
Том простил тебя?	Том дынæй ныббæрста?
Вы выиграли.	Сымах рамбылдтат.
Мы играли и смеялись.	Мах кафыдыстæм æмæ худтыстæм .
Я против.	Æз разы нæ дæн .
Садитесь здесь.	Ам æрбад.
Выйди.	Рахиз.
Успокоились!	Æрсабыр ут!
У меня паспорт украли.	Мæ паспорт мын адавтой.
Я должен выучить французский язык.	Æз хъуамæ сахуыр кæнон французаг æвзаг.
Вы тоже едете?	Сымах дæр цæут ?
Том жив.	Том удгас у?
Не пора ли тебе спать?	Афон дын нæу фынæй кæнын?
Вы слепой?	Куырм дæ?
Почему ты пропустил обед?	Цæмæн ауагътай сихор?
Что Том делал сегодня?	Том абон цы арæзта?
Идите за нами.	Нæ фæстæ рацыт.
Какое мне дело до Тома?	Мæн цы хъуыддаг ис Томмæ .
Том плавал.	Том ленк кодта .
Что ты творишь с Томом?	Цы ми кæныс Томæн ?
Гарантирую.	Фидардзырд дæттын.
Приезжай.	Æрцу.
Мы молоды.	Мах æвзонг стæм .
Начинать?	Райдайæм ?
Кошка мокрая.	Гæды хуылыз у.
Я и по-французски говорю.	Æз ма французаг æвзагыл дæр дзурын.
Том слаб.	Том æдых у .
Помните?	Хъуыды ма кæнут ?
Я не умру.	Æз нæ амæлдзынæн .
Не смейся!	Ма худ !
Как ты?	Куыддæ?
Пожалуйста, не беспокойтесь.	Табуафси , ма тыхс.
Том, ты врун!	Том сайæгой нæу!
Я изменюсь.	Æз аивдзынæн .
Сколько у вас детей?	Цал сывæллон уын ис ?
Возможно, Том не знает, что делать.	Æвæццæгæн ,Том нæ зоны цы хъæуы аразын уый.
Спрашивай.	Бафæрсут.
Том, наверно, ждет.	Том æвæццæгæн нхъæлмæ кæсы.
Вчера была плохая погода.	Знон æвзæр боныгъæд уыдис.
Он ходил туда-сюда.	Дыууæ рдæм рацу-бацу кодта .
Садитесь сюда.	Ардæм æрбадут.
Если хочешь, можешь остаться здесь.	Кæддæ фæнды, уæд ам æрлæу .
Когда ты едешь?	Кæд цæуыс?
Для тебя, Том, я всё сделаю!	Дæуæн Том , æз алцыдæр сараздзынæн .
Я не тупой.	Æз къуырма нæ дæн .
Том врёт.	Том сайгæ кæны.
Не поможете мне?	Нæ мын баххуыс кæндзыстут?
Том знает, почему он едет сюда?	Том зоны, цæмæ цæуы ардæм?
Поезжайте сейчас.	Ардæм æрцу.
Не перечь мне!	Ныхмæ мæм ма лæуу!
Можно я это потом сделаю?	Гæнæн ис мæ йæ стæй саразон?
Откуда у тебя такая уверенность?	Кæцæй дæм ис уыцы ныфс?
Позавчера мои друзья пришли ко мне в гости.	Æндæрæбон мæм ме’мбæлдтæ æрбацыдысты уазæгуат.
Мы арабы.	Мах арабтæ стæм.
Мы едим сырую рыбу.	Мах хæрæм хом кæсаг.
Все умерли.	Иууылдæр амардысты.
Ты что, еще не обедал?	Нæма сихор нæ бахордтай?
Куда Вы ходили?	Кæдæмты цыдыстут?
Кому мы должны денег?	Кæмæй дарæм æхца?
Вот что смешно.	Мæнæ цы ис худæг .
Том, если ты пойдёшь, я тоже пойду.	Том , кæд ды цæуай , уæд æз дæр ацæудзынæн .
Я её съел.	Æзæй бахордтон.
Ты американец?	Америкайнаг дæ?
Сегодня возможен дождь.	Гæнæн ис мæ абон къæвда уа.
Я вернулся домой с пустыми руками.	Æз хæдзармæ æрбацыдтæн афтид къухтимæ.
Как думаешь, в чем мне лучше пойти на завтрашнее свидание?	Куыд хъуыды кæныс, цæй мидæг ашæуон сом боны сæмбæлдмæ?
Том уехал.	Том ацыдис.
Оно красное.	Сырх у .
Все были в ужасе.	Иууылдæр уыдысты тасы.
Это было ужасное дело.	Тынг æвзæр хъуыддаг уыдис.
Давайте устроим вечеринку.	Цæйут саразæм хъазтизæр.
Я не знаю, когда Том вернётся из Бостона.	Æз нæ зонын , Том кæд æрцæудзынæн Бостонæй .
Мы болеем.	Мах рынчын стæм.
Я сегодня видел очень интересный сон.	Æз абон диссаджы фын федтон.
Я рад.	Æхсызгон мын у .
Выглядит очень дорогим.	Тынг хъæздыг зыны.
Том от голода не умрёт.	Том æхормагæй нæ амæлдзæн.
У тебя есть время пообедать?	Сихор бахæрыны рæстæг дын ис ?
На твоём месте я бы не стал помогать Тому.	Дæ бынаты ыз нæ баххуыс кодтаин Томæн
Том был на балконе.	Томы уыди балкъоныл
Она чувствовала, как у неё дрожат колени.	Йæ уæрджытæ куыд зыр-зыр кодтой , уый хатыдта .
Поел?	Бахордтай?
Темно.	Талынг .
Ты и я никогда не согласимся.	Æз æмæ ды иу дзырд мæ никуы рцæудзыстæм.
Повернись.	Разил .
Городу нужно больше велосипедных дорожек.	Горæтæн хъæуы фылдæр велопидон фæндæгтæ
Он купит новый велосипед на следующей неделе.	Уи балхæнджен велосипед иннæ къуыри
Хочешь встретиться со мной завтра вечером?	Кæддæ фæнды уæд фе’мбæлæм сом изæр ?
Она встретится с ним завтра.	Уи фембæлджен йемæ сом
Откуда берётся ветер?	Кæцæй цæуы дымгæ ?
Пиши мне.	Фысс мæм.
Так шумно.	Тынг хъæлæба .
Увидимся завтра?	Сом фе’мбæлдзыстæм?
А вы?	Сымах та ?
Это твой.	Ай дæу у .
Вы когда-нибудь ели устриц?	Сымах искуы хордтат устрицæтæ?
Я ем хлеб.	Æз дзул хæрын .
Меня интересует одна вещь.	Мæн цымыдис кæны иу хабар
Том, ты на каких языках говоришь?	Том , ды цы æвзæгтыл дзурыс ?
Она держит на руках младенца.	Сывæллоны йæ хъæбысы хæцы
Подождите!	Фæлæуут!
А где те деньги, что я вам вчера дал?	Знон уын цы хца радтон, уыдон кæм сты?
Они не могут сделать ничего другого.	Нæу сæ бон ндæр саразын
Никто не проверял этого.	Ничи йæ абæрæг кодта
Вы сильнее её.	Сымах умæй тыхджындæр стут
Это Тому.	Ай Томæн.
Что это был за звук?	Уый цы зæл уыдис ?
Том с Мэри?	Том Мэриимæ ис ?
Я слышал, что ты богат.	Афтæ фе’хъуыстон мæ хъæздыг дæ.
Том всё отрицал.	Том нæ сæтты.
Мы лгали.	Мах сайгæ кодтам.
Я сделаю, если покажешь как.	Æз сараздзынæн , кæд равдисай куыд хъæуы уый.
В общежитии, где он живёт, еда очень хорошая.	Æмдзæрæны, уый кæм цæры , ис тынг хорз хæрд .
Где я?	Кæм дæн?
Том танцует.	Том кафгæ кæны.
Я снова встал.	Нæуæгæй та сыстадтæн.
Кто она?	Чи у ?
Вру.	Сайын.
Он умён.	Зæнджын у.
Забудь.	Ферох кæн.
К какому возрасту ты хотела бы выйти замуж?	Цал азæй дæ фæндыдаит чындзы ацæуын.
Он ничего не писал.	Ницы фыста.
Я это знаю.	Æз ай зонын.
Слишком поздно.	Æгæр рæгмæ у .
Мне уйти?	Ацæуон ?
Поезжайте с кем хотите.	Рацæут кæимæ уæ фæнды.
Я не хочу, чтобы Том ехал с Мэри в Бостон.	Мæн нæ фæнды , цæмæй Том ацæуа Мэриимæ Бостонмæ .
Тому не нравится, когда его игнорируют.	Томы зæрдæмæ нæ цæуы , куы ницæмæйæ фæдарынц уый.
Могила!	Ингæн !
Я мешаю тебе?	Хъыгдарын дæ?
Буря стихла.	Уаддымгæ æрсабыр ис .
Интересно.	Кæддæра.
Забудьте меня.	Ферох мæ кæнут .
Том один?	Том иунæгæй ис ?
Я слышал, вы не едите мясо.	Афтæ фехъуыстон дзидза нæ хæрут.
Том знает французский.	Том зоны французаг æвзаг.
Просто не иди.	Ма ацу.
Ответьте мне.	Дзуапп ма мын раттут.
Извините.	Бахатыр кæнут .
Отойди!	Ахиз !
Уходи.	Ацу .
Берегись!	Дæхи хъахъхъæ!
Молчи!	Дæ дзыхыл хæц!
Вставай!	Уæлæмæ сыст!
Вставайте!	Уæлæмæ сыстут!
Стыдись!	Æфсæрмы кæн!
Правда?	Æцæг?
Развлекайтесь.	Уæ хи ивхæрсут.
Обернись.	Фæстæмæ фæзил.
Увидимся.	Фенæм кæрæдзи.
Успокойтесь.	Æрсабыр ут .
Зайдите!	Æрбахизут !
Зачем?	Цæмæ?
Знаем.	Зонæм .
Он сказал, что очень хочет есть.	Уи загъта, ома йæ тынг фæнды хæрын
Тебя-то кто туда звал?	Исчи дæ хуыдта уырдæм?
Когда ты в последний раз писал Тому?	Томæн фæстаг хатт кæд ныффысстай?
Давайте пойдём назад тем же путём, которым мы пришли сюда.	Уæдæ æцæуæм фæстæмæ уыцы фæндагыл, кацыйл бацыдыстам
Я ни о чём другом думать не могу.	Мæ бон нау æндæрыл хъуыды кæнын
Я не могу пить алкоголь.	Мæ бон алкоголь нуазын нæу.
Вы дверь закрыли?	Дуар сæхгæдтат?
Сколько ты хочешь молока?	Æхсыр дæ цас хъæуы?
Плохо тебе?	Æвзæр дын у?
Мария очень любит живые цветы.	Мария тынг уарзы дидинджытæ.
Что Вам известно о ЦРУ?	ЦРУйы тыххæй цы зону?
Есть никто не хотел.	Хæрын никæйы нæ фæндыди.
Вы не боитесь?	Нæ тæрсут?
Я без Тома не пойду.	Æнæ Томæй нæ ацæудзынæн.
Кофе у тебя найдётся?	Кофе дæм ис?
Работать не тяжело.	Кусын зын нæу.
Я очень люблю театр.	Æз тынг уарзын театр.
Это была не я! Это был он!	Æз нæ уыдтæн! Уый уыди!
Почему Том так поступает?	Том афтæ цæмæн кæны?
Том много плачет?	Том бирæ кæуы?
Его отец — японец.	Йæ фыд япойнаг у.
Не теряйте времени.	Рæстæг ма сафут.
Почему ты сидишь на моём стуле?	Мæ бандоныл цæмæн бадыс?
Мы не пели.	Заргæ нæ кодтам.
Мы не пели.	Мах нæ зарыдыстæм.
Том первый вошёл в пещеру.	Фыццаг лæгæтмæ бацыди Том.
Ты совсем ненормальный?	Æрра дæ?
Том очень красивый.	Том тынг рæсугъд у.
Вызывайте полицию!	Пъæлицæмæ бадзурут.
Давайте играть в прятки.	Æмбæхсынтæй ахъазæм.
Мы сделали что-то неправильно?	Мах исты раст нæ сарыстам?
Зачем Том остаётся?	Том цæмæн баззайы?
Деньги у вас с собой?	Хша дæм ис?
Я понимаю вас, когда вы не очень быстро говорите.	Тагъд иу куынна дзурут уад иу уа æмбарын
Я и не думал тебя обманывать.	Нæдæр хъуыды кодтон дæу сайн
Полагаю, я должен извиниться.	Ыз æфтæ хъуыды кæнын, мæ хъомæ хатыртæ ракуырон
Я хочу поехать с Томом в Бостон.	Томимæ мæ фæнды Бостонмæ ацæуын.
Он занят.	Уийы не ’вдӕлы
Как я раньше жила без него?	Нæ уымæй куыд цардтæн раздæр?
Сначала я ему не поверил.	Фыццыгæй йыл нæ баууæндыдтæн.
Когда нам ей сказать?	Кæд йын æй зæгъæм?
Завтра ты будешь счастлив.	Сом амондджын уыдзынæ.
Том сказал мне, что ему нравится эта идея.	Том мын зæгъдтæ æмæ уый зæрдæмæ цæуынц уыцы хъуыдытæ
Давайте я расскажу вам, как это можно сделать.	Цæйут æз уын радзурон, куыдæй ис гæнæн саразын.
Ты меня за придурка не держи!	Ды мæ æдылыйыл ма нымай!
Я умею прыгать.	Ыз зонын гæпп кæнын
В книге есть страницы.	Чиныгы ис фæрстæ
Надеюсь, он меня ждёт.	Ныфс мæ ис , кæй мæм нхъæлмæ кæсы.
Вы хотите, чтобы я ей позвонил?	Сымах фæнды, цæмæй йæм æз фæдзурон ?
Старый пёс лаял.	Зæронд куыдз рæйыды
Я сегодня ходил к зубному.	Ыз абон уыдтан дохтырмæ
Том бежал.	Том лыгъдис.
Что собираетесь делать вечером?	Цы хъавут аразын изæры?
Хочешь заплатить прямо сейчас или попозже?	Ерын дæ фæнды бафидын æви стæ?
Нам это нужно делать каждый день.	Махæн ай алы бон дæр хъæуы аразын.
Почему он плачет?	Уи цæмæ кæуы?
Детям велели занять свои места.	Сывæллæттæн загътон сæ бынæдтæ бацахсыг.
Рыбы не любят солнечный свет.	Кæсæгтæ нæ уарзынц хуры рухс.
Том сказал мне, что споёт.	Том мын загъта, кæй азардзæнис уый.
Я сейчас говорю с моим другом по телефону.	Æз ен тæккæ ме’мбалимæ телефонæй дзурын.
Он знал его?	Зыдта йæ?
Я сказал тебе, чтобы ты не разговаривал с Томом.	Æз дын загътон ,цæмæй Томимæ ма дзурай.
Цветам и деревьям нужны чистый воздух и свежая вода.	Дидинджыты æмæ бæлæсты хъæуы сыгъдæг уæлдæф æмæ ног дон.
Том оказался сильнее, чем его противник.	Том тыхджындæр разындис , йæ ныхмæлæууæгæй.
Мы подумываем о переезде.	Мах ахъуыды кæндзыстæ ацыдыл иу ранæй иннæмæ.
Через два года она уже бегло говорила по-немецки.	Дыууæ азы фæстæ дзæбæх дзырдта немцаг æвзагыл.
Давно её нет?	Рагæй нæй?
Том сказал, это, мол, просто прикол.	Том загъта, уый дам хъынджылæг у .
Возможно, я оставила зонтик в автобусе.	Чи зоны, автобуса ныууагътон мæ зонт.
Я даже не знаю твоего настоящего имени.	Æз дын дæ цæг ном дæр нæ зонын .
Хорошие люди попадают в рай.	Дзæбæх адæм дзæнæтмæ бахауынц .
Сломай за́мок.	Ныппырх кæн чесена.
Лучше я вернусь к работе.	Фæлтау куыстмæ æрбацæудзынæн.
Том хочет внимания.	Томы хъæуы æдзынæгдзинад.
Том никогда не влюблялся.	Том никуы уарзта.
Ворота были заперты.	Дуæрттæ уыдысты хгæд.
Если бы у меня было чуть больше денег, я бы его купил.	Гыццыл ма мæм фылдæр хца куы уыдаит , уæдæй балхæдтаин.
Вы думали, я действительно это выпью?	Сымах хъуыды кодтат, æз æнæмæнгæй ай бануаздзынæн?
Том построил свой собственный дом.	Том самадта йæхи хæдзар.
Папа, я тебя люблю.	Дада, æз дæу бирæ уарзын.
Многое тебе понравится.	Бирæ цы дæр тæ фæцæудзæнис дæ зæрдæмæ.
Она всё ломает.	Алцыдæр цъæл кæны.
Как можно быстро выучить иностранный язык?	Куыд ис гæнæн тагъд фæсарæйнаг æвзаг сахуыр кæнын?
То время прошло.	Рæстæг æрцыдис.
Я всегда вас слушаю.	Æз уæм алы хатт дæр фæхъусын.
Дедушка Тома был неграмотным.	Томы баба уыдис æнахуыргонд.
Мы учимся с ним в одном классе.	Иу кълассы ахуыр кæнæм.
Я не смог разбудить Тома.	Мæ бон не’ си Томы райхъал кæнын.
Он говорит, что отлично провёл выходные.	Афта дзырдта , дзæбæх дам арвыстон мæ æнцойбон.
Надо было найти формулу.	Формулæ хъуыдис ссарын.
"Здесь я построю город", — сказал Пётр. Шёл 1703 год.	«Ам æз сараздзынæн горæт»,- загъта Пётр.
Если Том этого не писал, то кто?	Кæдæй Том нæ ныффыста , уæд чи ?
Я в двенадцать перезвоню.	Дыууадæс сахатыл дæб бадзурдзынæн.
Они ненавидят женщин.	Сæ уæнгæл уынынц сылгоймæгтæй.
Он всегда со мной.	Кæд фæнды дæр ме’мæ ис .
Скажи Тому, чтобы не приходил.	Зæгъ Томæн, цæмæй ма рбацæуа .
Я хотел покрасить волосы.	Мæн фæндыдис сахурын мæ сæрыхъуынтæ.
Мне знакомо это чувство.	Мæнæн зонгæ у уыцы æнкъарæн.
У неё есть дядя, который работает в банке.	Уымæн ис мадыфсымæр , кæцы кусы банкы.
Вам нравится то, что вы делаете?	Цы аразут , уый уæ зæрдæмæ цæуы .
Я думаю, Том нашёл новую работу.	Æз хъуыды кæнын, Том ссардта ног куыст.
Мы дожидаться его не стали.	Мах йæм æнхъæлмæ нал кастыстæм.
Хороший был день?	Хорз бон уыди?
У этой машины не хватает какой-то части.	Ацы машинæйы цыдæр хай нæ фаг кæны.
Давай забудем о прошлом и поговорим о будущем.	Цæй ферох кæнæм цы уыдис уый , æмæ адзурæм сомбоныл.
Они играют в карты.	Къамтæй хъазынц.
Дэн идёт домой.	Дэн йæ хæдзармæ цæуы.
Книга твоя.	Чиныг дæу у.
Теперь Том знает, как это делается.	Ныр Том зоны куыд кæнын хъæуы.
Это для птиц.	Ай цъиуæн у.
Лучше пить шампанское вместо колы.	Колæйы бæстæ шампайнаг хуыздæр уыдзæн баназын.
Вы лучше неё.	Ды йæ хуыздæрдæр дæ.
Лицо Лейлы было всё в крови.	Лейлайы цæсгом туджы уыди.
Я учусь на врача.	Æз дохтырыл ахуыр кæнын.
Мне завтра утром рано вставать.	Æз райсом раджы стын.
Я уверен, что Том будет пьян.	Æз зонын, Том уыдзæн расыг.
Я тебя не искал.	Æз дæ агургæ нæ кодтон.
Он подарил ей кольцо с бриллиантами.	Лæппу къухдарæнын бриллиантимæ чызгæн балæвар кодта.
Осторожно: двери закрываются!	Уæхимæ кæсут: дуæрттæ ахгæнынц!
Сколько стоят эти апельсины?	Ацы апельсинтæ цас кæнынц?
Самолёт садится.	Хæдтæхæг æрбады.
Ты хоть иногда голову включай.	Искуы иу хатт дæ сæр скусын кæн.
Ты хоть иногда голову включай.	Искуы иу хатт дæ сæрæй ахъуыды кæн.
"Ты не видел мой мобильный телефон?" - "Он на столе".	"Нæ федтай мæ телефон?"- "Стъолыл и."
Я беднею.	Æз мæгуырдæр кæнын.
Том показал мне, как делать пиццу.	Том мын равдыста куыд кæнын хъæуы пиццæ.
Самолёт приземлится в семь часов вечера.	Хæдтæхæг æрбацæн изæрæй авд сахатыл.
Мы думали, что проделали хорошую работу.	Мах хъуыды кодтам цæмæй хорз акусыдыстæм.
Как вы думаете, сколько времени у нас на это уйдёт?	Куыд хъуыды кæнут, цас рæстæг нæ бахъæудзæн?
Почему вы выключили телевизор?	Телевизор цæмæн ахуысын кодтат?
Твоя собака кусается?	Дæ куыдз хæцы?
Простых ответов не существует.	Хуымæтæг дзуаппытæ нæй.
Я хочу иметь настоящий дом с садом.	Мæн фæнды æцæг хæдзар цæхæрадонимæ.
Вы не можете уйти.	Уæ бон нæу ацæуын.
Дай я ещё раз гляну.	Æри ма, иу хатт ма йæм æркæсон.
Не беспокойтесь о моей собаке.	Мæ куыдзы тыххæй ма тыхсут.
Никто не утверждает, что он святой.	Ничи нæ загъы цæмæ дзуар у.
Они продают конфеты.	Уыдон къафеттæ уæй кæнынц.
Мы купили квартиру недавно.	Мах ибон фатер балхæтам.
Я рада за Тома.	Æз Томы тыххæй цин кæнын.
Ни один канадец никогда такого бы не сказал.	Иунæг канадæйаг афтæ никуы нæ загътаид.
Гибралтар — это страна?	Гибралтар бæстæ у?
Я всё делаю сама.	Алцыдæр мæхæдæг кæнын.
Это я написала письмо.	Æз ныффысстон писмо.
Я никогда не буду таким, как Том.	Æз Томы хуызæн никуы нæ уыдзынæн.
Что-то мне не хочется работать.	Кусын мæ цыдæр нæ фæнды.
Они ждали больше часа.	Сахатæй фылдæр æнхъæлмæ кæсынц.
Я не сказал им, что ты здесь.	Нæ цын загътон цæмæй ам дæ.
Она видела, как он поедал сэндвич.	Чызг федта лæппу сэндвич куыд хордта уый.
Моя мама была против того, чтобы я ехал один.	Мæ мады нæ фæндыди цæмæй æз иунæгæй цæуон.
Вернувшись домой из школы, она принялась помогать матери на кухне.	Чызг скъолайæ хæдзармæ куы æрбацыди, уæд йæ мадæн къухынийы æххуыс кæнын райдыдта.
Погоди ещё одну минутку, хорошо?	Иу минут ма фæлæу, хорз?
Я с самого утра голодный.	Æз райсомæй æххормаг дæн.
В следующем году Тому будет сто лет.	Иннæ азы Томæн уыдзæн сæдæ азы.
Раньше Исландия принадлежала Дании.	Раздæр Исланди Данийы уыди.
Мы идём ко дну.	Мах цæуæм бынмæ.
Вы умнее их.	Сымах уыдонæй зæнджындæр стут.
У человека есть способность разговаривать.	Адæймагæн ис арæхстдзинад дзурын.
Думаю, Том сильно злится.	Хъуыды кæнын , Том тынг мæсты у.
Вы слушаете, что я говорю?	Хъусут цы дзурын?
Ему нравятся рассказы.	Йæ зæрдæмæ цæуынц радзырдтæ.
Я вспомнил, что забыл покормить собаку.	Æрхъуыды кодтон , кæй мæ ферох ис куыдзæн хæринга раттын .
Почему ты до сих пор стоишь?	Цæмæ лæууыс ерын мæ?
Я бы хотел, чтобы ты сделал то, что тебе говорят.	Мæн фæндит, цæмæй ды саразай , цы дын дзурынц æуый.
Хотите знать, почему я врал Тому?	Фæнды зонын, цæмæ сайдтон Томы?
Это искусственный язык.	Ай аразгæ æвзаг у .
Книга на столе?	Чиныг столыл ис ?
Может быть, она Вас любит.	Æвæццæгæн уæ уырзгæ кæны .
Почему Том не приедет с вами в Бостон?	Цæмæнæ æрцæудзæн Том сымахимæ Бостонмæ?
Я могу посчитать.	Мæ бон у банымайын.
Ответьте на вопрос.	Дзуапп раттут фарстайæн .
Том сказал, что ему холодно.	Том загъта, уазал йын кæй у уый .
Узел завязан?	Æлхынцъ баст у ?
Не раздражай никого.	Мæстæй макæй мар .
Хотите уйти - пожалуйста.	Фæнды уæ ацæуын - табуафси.
Я увидел.	Æз федтон .
Мы не жалеем об этом решении.	Мах нæ фæсмон кæнæм уыцы уынаффæйадыл.
Ты был преподавателем больше тридцати лет.	Ды уыдтæ ахуыргæнæг дæс æмæ ссæдз азæй фылдæр .
Том не хочет учиться в Бостоне.	Томы нæ фæнды Бостоны ахуыр кæнын.
Нас ждало удивительное открытие.	Диссаджы раргом нæм æнхъæлмæ кастис .
Скажите мне об этом завтра, пожалуйста.	Сом иу мын æй зæгъут, табуафси .
Том вышел из тюрьмы по УДО.	Том рацыд ахæстонæй УДО
Ты что это хочешь сказать?	Уый дæ цы фæнды зæгъын?
Я просто хотел пойти домой.	Мæн фæндыд хæдзармæ ацæуын.
Я не знаю, что Том посоветовал Вам сделать, но не рассказывайте об этом Мэри.	Æз нæ зонын,цы уын загъта Том саразын, фæлæ йæ ма радзурут Мэрийæн.
Пусть Том немного повеселится.	Уадз мæ Том гыццыл йæ хи аирхæфса.
Я не хотела их беспокоить.	Нæ мæ сæ фæндыд бахъыгдарын.
Важно, чтобы вы понимали.	Стырдзырду , цæмæй йæ æмбарат.
У него красные цветы.	Уымæн сырх хуыз у.
Давайте за это выпьем.	Цæйут уый тыххæй бануазæм .
Поделите, пожалуйста, пиццу на три части.	Табуафси , адих кæнут пиццæ æртæ хайыл.
Вот то, чего вы хотели.	Мæнæ, сымах цы хъуыдис .
Не знаю, как ты, а я уже ничего не понимаю.	Нæ зонын , ды куыд , фæлæ æз ницы мбарын.
Осторожно, у шефа сегодня плохое настроение.	Сабыргай, хицауæн абон æвзæр зæрдæйы ахаст ис .
Мы с ним её боимся.	Мах дзы тæрсгæ кæнæм .
Я не знаю, на каком автобусе ехать.	Æз нæ зонын , кæцы автобусыл хъæуы цæуын.
Я рассказал ей, что случилось.	Æз йын радзырдтон , цы хабар æрцыдис уый ,
Может быть, я просто сумасшедший.	Æвæццæн , æз æдылы дæн .
Ты ведь часто говоришь с друзьями по-французски?	Ды хо арæх дзурыс де’ мбæлдтаимæ французаг æвзагыл ?
Повсюду был мусор.	Алы рдыгæй уыдис бырон.
Ты хорошо говоришь на английском, не так ли?	Ды хо дзæбæх дзурыс англисаг æвзагыл, афтæ нæу ?
Он снова закрыл глаза.	Ногæй та йæ цæстытæ сыхгæдта.
Почему она не захотела помочь?	Цæмæнæ йæ бафæндыд баххуыс кæнын?
Я хочу пиццу.	Пиццæ мæ хъæуы.
Вы слишком старая.	Сымах гæр зæронд стут .
Сегодня светит солнце.	Абон хур кæсы.
Он будет кричать.	Хъæр кæндзæнис.
Пожалуйста, просто отвези меня домой.	Табуафси , хæдзармæ ма мæ акæнут.
Жизнь? Не говори мне про жизнь.	Цард? Ма мын дзур царды тыххæй .
Том всё ещё хочет, чтобы вы помогли ему.	Томы нæма фæнды , цæмæй йын баххуыс кæнат.
Не хочешь пойти погулять в парк?	Нæ дæ фæнды атезгъо кæнын паркы рдæм.
Он надел лучшую одежду.	Йæ хуыздæр дзаума скодта.
Том простит меня.	Том мын æй ныххатыр кæндзæнис.
Её парень - идиот.	Йæ уарзон -сæрхъæн у .
Собака должна оставаться на улице!	Куыдз хъуамæ уынгы уа.
Я бы купил его, если бы он не был такой дорогой.	Æз æй балхæдтаин, афтæ зынаргъ куы нæ уыдаит уæд .
Я подождал три минуты.	Æз æнхъæлмæ кастæн æртæ минут .
У тебя есть какое-нибудь хобби, Том?	Исты хуызон хобби дын ис , Том ?
Цена будет расти.	Аргъ рæздзæнис .
Том тебя послушал?	Том дæм байхъуыста?
У нас есть место.	Махæн ис бынат.
Она не знала, что говорить.	Цы дзура, уый нæ зыдта.
Ты из Австрии или из Австралии?	Ды Австрийæ дæ æви Австралийæ?
Я не расслышал его имени.	Йæ ном йын нæ фехъуыстон.
Я звонил утром Тому, но он не брал трубку.	Æз дзырдтон райсомæй Томмæ, фæлæ нæ иста трубка .
Однажды он убил себя.	Иу хатт йæхи амардта.
Том отказался отвечать на наши вопросы.	Том несразы ис дзуыпп дæттын нæ фарстатæн .
Я встретил его вчера.	Знон фе’мбæлдыстæм.
Том и Мэри не думают, что они храпят.	Том æмæ Мэри нæ хъуыды кæнынц, мæ хуыр-хуыр кæнынц.
Когда она отправила тебе свои фотографии?	Кæд дæм арвыста йæ нывтæ?
Моя девушка уехала в Канаду.	Мæ уарзон ацыдис Канадæмæ.
Почему у тебя на глазу повязка?	Дæ цæст баст цæмæн у .
Том посоветовал Мэри взять с собой зонтик.	Том загъта Мэрийæн цæмæй йе’ мæ райса зонт .
У Тома есть кошка.	Томæн ис гæды.
Я ничего не хочу забывать.	Мæн ницы фæнды рох кæнын.
Голосуй за Тома.	Хъæлæс ратт Томæн.
Том подстрелил собаку.	Том куыдзы фе’хста .
Мэри приехала с Томом.	Мэри æрцыдис Томимæ.
Не приближайся к нам!	Æввахс мæм ма цу!
То платье тебе идёт.	Уыцы къаба дыл фидауы.
Я знаю тебя много лет.	Бирæ аз тæ дыл цæуы зонынæй.
Я разговариваю во сне.	Æз фыны фæ дзурын .
Что вы пели?	Цы зарыдыстут?
Я не могу вспомнить, что ел вчера вечером.	Мæ бон нæу рхъуыды кæнын, цы хордтон знон изæрæй.
Погода очень плохая.	Боныгъæд тынг æвзæр у .
Тебе надо помыть руки.	Дæ къухтæ ныхсын дæ хъæуы.
Вопрос в том, придёт она всё-таки или нет.	Фарста уый мидæг ис , æрбацæдзæн æви нæйы.
Сколько яиц?	Цал аик?
Расскажи мне, как играть в эту игру.	Радзурма мын , куыд хъæуы хъазын ацы хъазтæй.
Мы хотим помочь нашим друзьям.	Мах фæнды баххуыс кæнын не’мбæлдтæн.
Я знаю, что мне надо многому научиться.	Æз зонын , мæн бирæ хъæуы нæма сахуыр кæнын.
Ты нас спас.	Ды мах фе’рвæзын кодтай.
Я думал, что Том учит французский.	Æз хъуыд кодтон , Том французаг ахуыр кæны.
Я читаю это предложение.	Æз кæсын ацы хъуыдыйыд.
Я буду минут через тридцать.	Æз уыдзынæн дæс æмæ ссæдз минуты фæстæ.
Я узнал твой секрет.	Æз дын базыдтон дæ сусæг .
Все знают, что мы этого не делали.	Иууылдæр зонынц, мах уый кæй нæ сарæзтам уый.
У меня есть для тебя сообщение от неё.	Мæнмæ дын ис сообщени уымæй.
Мэри думает, что Том - убийца.	Мэри хъуыды кæны, Том -лæг марæг кæй у уый .
Ваша корова ест наши цветы.	Дæ хъуг нæ дидинджытæ хæры.
Ты сам затеял этот разговор.	Ды дæхæдæг рафæнд кодтай ацы ныхас.
Выживем только мы.	Баззайдзыстæм æрмæстæр мах.
Том опять начал ходить в церковь.	Том ногæй райдыдта аргъуанмæ цæуын.
Я люблю спать с открытым окном.	Æз уарзын фынæй кæнын гом рудзынгимæ.
У Мэри есть рот, но нет языка.	Мэрийæн дзых ис, фæлæ æвзаг нæй.
Мы всё ещё друзья?	Æмбæлттæ ма стæм?
Скажите Тому, чтобы не уходил.	Томæн зæгъ цамæ ма ацæуа.
У вас продаются авокадо?	Авокадо уæй кæнут?
Сейчас узнаем.	Ныртæккæ базондзыстæм.
Том дал ключ мне, и он до сих пор у меня.	Том мын дæгъæл радта æмæ мæнмæ ма йы.
Том уснул на полу.	Том пъолыл бафынæй кодта.
Я обычно здесь завтракаю.	Æз арæх хæрын ам райсомæй.
Мне очень нравится такая погода.	Æз тынг уарзын ахæм бонахаст.
Вы впервые в этом городе?	Ды ацы горæты фыццаг хатт дæ?
Вы впервые в этом городе?	Смах ацы горæты фыццаг хатт стут?
Он забыл свитер.	Лæппу свитер ферох кодта.
Кто в наше время пишет письма?	Мах рæстæджы чи фыссы писмо?
Том весь день плавал.	Том æнæхъæн бон кæугæ кодта.
Вы пробовали этот торт?	Ацы торт апроб кодтай?
Я скажу нет.	Æз зæгъдзынæн на.
Сейчас поем и поеду.	Ныртæккæ бахæрдзынæн æмæ ацæудзынæн.
Голова у Лейлы была побрита.	Лейлайæн йæ сæр даст уыди.
Мой отец очень устал.	Мæ фыд тынг бафæллади.
Я знаю её уже десять лет.	Æз æй дæс азы зонын.
Том сказал мне сюда прийти.	Том мын загъта ардæм æрбацæуын.
Так можно сказать по-русски?	Афтæ уырыссагау гæнæн ис зæгъын?
Том на самом деле никогда не хотел продавать свой дом.	Том æцæгæй йæ хæдзар никуы нæ фæндыди уæй кæын.
Том выиграл состязание.	Том ерыс рамбылдта.
Том и Мэри говорят.	Том æмæ Мэри дзургæ кæнынц.
Том мало знает об Австралии.	Том Австралийы тыххæй гыццыл зон.
Куда пошли другие девушки?	Кæдæм ацыдысты иннæ чызджытæ?
Он пойдёт пешком.	Лæппу фистæгæй ацæудзæн.
Мне пойти с вами?	Смахимæ ацæуон?
Я не люблю покупать дорогие вещи.	Æз нæ уарзын æлхæнын зынаргъ дзаумæттæ.
Этот кот не охотится на мышей.	Ацы гæды мыстытыл цуан нæ кæны.
Вы пьёте чай?	Цай нуазут?
Ты будил Тома.	Ды Томы хъал кодтай.
Спой с нами.	Махимæ азар.
Какой вам нравится?	Уæ зæрдæмæ чи цæуы?
Кто в этом поезде?	Чи йы ацы поезды?
Том был не согласен.	Том разы нæ уыди.
Мэри показала ему мир.	Мэри йын дуне равдыста.
Он будет здесь около двух часов.	Лæппу ам уыдзæн дыууæ сахаты.
Я хочу знать, как в точности умер Том.	Мæн фæнды зонын Том куыд амарди уый.
Я останусь только на несколько дней.	Æз баззайдзынæн æрмæстæр цалдæр боны.
Я ничего не хотел.	Мæн ницы нæ хъуыди.
Мне сложно его понять.	Мæнæн зын у йæ бамбарын.
Прекратите орать!	Мауал хъæр кæнут!
Том всё ещё читает.	Том ма кæскæ кæны.
Приближается гроза.	Тæрккъæвда фæцæйхæццæ кæны.
Вы не хотите знать, где я был?	Нæ уæ фæнды зонын кæм уыдтæн?
Она родила сына.	Ус лæппуйы райгуырдта.
Покажи мне на карте Пуэрто-Рико.	Картæйыл мын Пуэрто-Рико равдис.
Это турецкая традиция.	Ай у туркаг традици.
Я работаю здесь.	Æз ам кусын.
Пожалуйста, успокойся.	Табуафси басабыр у.
Нет.	На.
Солнце больше Луны.	Хур мæйы дынджардæр у.
У Вас есть манго?	Манго уæм ис?
Почему вы пошли в политику?	Политикæмæ цæмæн ацыдыстут?
Что сегодня было?	Абон цы уыди?
Думаю, Том вам скажет.	Мæнмæ гæсгæ Том уын зæгъдзæн.
Порядковый номер урана - 92.	Радон номыр уранæн - 92.
Я тут где-то свой ключ потерял.	Æз ам кæмдæр мæ дæгъæл фесæфтон.
Ты почти прав.	Растмæ æввахс дæ.
Ты сказал мне, что был там вчера.	Ды мын загътай знон уым уыдтæ.
Его голос пугает меня.	Йæ хъæлæс мæ тæрсын кæны.
Я видела вас вчера.	Æз уæ знон федтон.
Я никогда не видела жирафа до того, как я посетила зоопарк.	Æз никуы нæ федтон жирафы цалынмæ сырдонмæ нæ ацыдтæн уæдмæ.
Орёл белый.	Цæргæс урс у.
Как мы можем остановить Тома?	Томы нæ бон куыд у бауромын?
Том положил деньги в сейф.	Том æхца сейфы сывæрдта.
Мы этого не узнаем.	Мах æй нæ базондзыстæм.
Девушка с длинными волосами - Мэри.	Чызг даргъ сæрыхъуынтимæ Мэри у.
Перестань меня кусать.	Мауал мыл хæц.
Где вы вчера были? Я вас вечером искала.	Кæм уыдыстут знон? Æз уæ изæрæй агургæ кодтон.
Мы больше не придём.	Мах нал æрбацæудзыстæм.
Почему ты не ищешь работу?	Куыст цæуылнæ нæ агурыс?
Не забывайте, кто вы.	Ма рох кæнут чи стут уый.
Не стесняйтесь спрашивать.	Фæрсын æфсæрмы ма кæнут.
Пьер заболел.	Пьер барынчын и.
Тебе нехорошо?	Æвзæр дын у?
Я буду здесь в понедельник.	Æз ам къуырисæры уыдзынæн.
Он любит кошек?	Гæдытæ уарзы?
Ты хочешь, чтобы я с ней поговорил?	Дæу фæнды , цæмæй йе’мæ аныхас кæнон?
Я купил немного вот этого сыра.	Æз ацы цыхтæй гыццыл балхæдтон.
Мне нужно купить одну.	Мæн хъæуы иу балхæнын.
Ни Том, ни Мэри не были удивлены.	Нæдæр Томмæ , нæдæр Мэримæ диссаг нæ фæкастис.
Она пытается свистеть, но не знает, как.	Æхсистт кæнын хъавы фæлæ нæ зоны куыд.
Мы бывали там раньше.	Мах раздæр уым уыдыстæм.
Я никогда не изучал украинский.	Украинаг ахуыр никуы нæ кодтон.
А почему нет?	Цæмæннæ?
Говорят, он очень богатый.	Адæм зæгъы тынг хъæздыг у.
Ну извини, это уже не мои проблемы.	Бахатыр кæн , уыдон мæ райхалинаг фарстытæ не’ сты .
Том сел на лошадь.	Том бæхыл сбадти.
Родители разрешают тебе есть конфеты?	Ныййырджытæ дын уазынц адджинаг хæрын?
Том всегда помогал людям бесплатно.	Том алы хатт дæр адæмæн фе’хуысс кæны лæварæй .
Чего от вас хотели эти двое мужчин?	Цы хъуыдис уыцы дыууæ нæлгоймагы сымахæй?
Возьмите мою машину.	Мæ машинæ райсут.
Том лгал другим.	Том сайдта иннæты.
Это всё для вас.	Алцыдæр смахæн.
Земля слишком маленькая.	Зæхх æгæр гыццыл у .
Мы считали тебя сыном.	Мах дæ нæ лæппуйыл нымадтам.
Предложения с номером 264405 не существует.	Хъуыдыйад 264405 номыримæ нæй.
Он жил один.	Иунæгæй царгæ кодта.
Я вышел раньше, чтобы сесть на первый автобус.	Æз рахыстæн раздæр , цæмæй фыццыг автобусыл сбадон.
Я дарю ей это.	Æз йын ай балæвар кæндзынæн .
Вы боитесь собак?	Куитæй тæрскæ кæнут?
Не покажешь мне свой альбом?	Дæ альбом мын нæ равдисдзынæ?
Том сломал себе обе ноги.	Том йæ дыууæ къах дæр ацъæл кодта.
Я должна остановиться.	Мæн хъæуы бауромын.
Кто Вас прислал?	Чи уæ æрбарвыста?
Наденьте эту шаль.	Ацы кæлмæрзæн скæнут.
Нам нужно отдохнуть друг от друга.	Махæн хъæуы кæрæдзийæ баулæфын.
Болезнь уносит здоровье.	Низ ахæссы æнæниздзинад.
Тому и Мэри нравится такая музыка?	Том æмæ Мэрийы зæрдæмæ цæуы ахæм музыкæ?
Два крольчонка, белый и чёрный, жили в большом лесу.	Дыууæ хæдзарон тæрхъусы, урс æмæ сау, дынджыр хъæды цардысты.
Я потанцую с ним.	Æз акафдзынæн йе’мæ.
Мэри завопила.	Мэри ныхъхъæр кодта.
Куда он положил свой ключ?	Кæм сывæрдта йæ дæгъæл?
Том сидел один в темноте.	Том иунæгæй бадтис талынгы.
Ответа долго не было.	Дзуап бирæ нæ уыди.
Это не детские книги.	Сабион чингуытæ не сты.
Она поймала курицу.	Чызг карк æрцахста.
Ты из Нью-Йорка?	Нью-Йоркæй дæ?
Я не могла защитить её.	Мæ бонæй не’сси бахъахъæнын.
Видите, как надо?	Уынут, куыд хъæуы?
Том, наверное, не знает телефон Мэри.	Том, æвæццæгæн, Мэрийы телефон нæ зоны.
Почему ты просто не сказал ему?	Цæмæнæ йын æй загътай?
Мы скоро узнаем всё, что нам нужно.	Мах тагъд базондзыстæм, цы нæ хъæуы уый .
Вы тоже новенькие?	Сымах дæр нæуджытæ стут?
Мы все к этому готовы.	Мах уымæ цæттæ стæм .
Я себе нравлюсь.	Æз мæ зæрдæмæ цæуын.
Он спрятан где-то в лесу.	Æмбæхстис кæм дæр хъæды.
Том каждый день гулял с собакой.	Том алы бон йæ куыдзимæ тезгъо кæны.
Когда родились твои дети?	Кæд райгуырдысты дæ сывæллæттæ ?
Мне нужно поехать в Бостон.	Мæн хъæуы Бостонмæ ацæуын.
Вы всё ещё играете на гитаре?	Сымах нæма хъазут гитарæйыл?
Ты ещё поёшь с Томом?	Ды нæма Томимæ зарыс?
Я не хочу такой диван покупать.	Мæн нæ фæнды ахæм диван æлхæнын.
Том покрасил волосы.	Том сахуырста йæ сæрыхъуынтæ.
Нам нельзя здесь плавать.	Махæн нæй гæнæн ам ленк кæнын.
И где он живёт, этот Том?	Кæм цæры ацы Том?
Конечно, вы правы.	Куыннæ , сымах раст стут .
Была моя очередь?	Мæ рад уыдис ?
Я вернусь через три недели.	Æртæ къуырийы фæстæ фæстæмæ æрбацæудзынæн.
Мы отвезём тебя домой.	Мах дæ дæхимæ аласцыстæм.
Иди обратно внутрь.	Фæстæмæ мидæмæ бацу.
Под шум дождя хорошо думается.	Къæвдайы хъæлæбамæ хорз хъуыды кæны.
Следующей весной в поеду в Бостон.	Иннæ уалдзæджы Бостонмæ ацæудзынæн.
Том, дашь мне домашку по математике списать?	Том , ратт ма мæ математикæйæ хæдзарон куыст сфыссын?
Я часто дарю ей цветы.	Æз йын арæх балæвар кæнын дидинджытæ.
Наблюдайте за ним.	Йæ фæстæ кæскæ кæнут.
Можно мне его увидеть?	Гæнæн ис мæ йæ фенон ?
Думаю, Том сказал мне правду.	Хъуыды кæнын, Том мын раст загъта.
Я родился в том же году, в котором умер мой дед.	Æз райгурдтæн уыцы аз , кæцыйы амардис мæ баба.
Раньше это было кафе.	Раздæр кафе уыди.
Это мои.	Адон мæн сты.
Не думаю, что Том поедет в Бостон.	Нæ хъуыды кæнын, мæ Том Бостонмæ ацæудзен.
Я написал тебе десять писем.	Æз дын дын дæс писмойы ныффысстон.
Мы приехали на машине.	Мах машинæйыл æрбацыдыстæм.
Кто выпил всё пиво?	Æнæхъæн бæгæны чи банызта.
Джуди обожает танцевать.	Джуди тынг уарзы кафын.
У Тома с французским гораздо лучше, чем у меня.	Томæн французаг æвзагимæ бирæ хуыздæр у , мæуонæй.
Просто забудь!	Ферохæй кæн!
Я хочу большую свадьбу.	Мæн хъæуы стыр чындзæхсæв .
Эти часы надо починить.	Ацы сахат хъæуы саразын.
Хочешь погулять со мной завтра вечером?	Фæндыдæ ме’мæ атезгъо кæнын сом изæр ?
Мы с Томом пойдём за Мэри.	Мах Томимæ Мэрийы фæстæ ацæуæм.
Они взяли Тома с собой.	Уыдон Томы семæ райстой.
Вы американец или европеец?	Сымах америйнаг стут æви европейаг?
Они знают, что мы сделали.	Уыдон зонынц мах цы скодтам уый.
У нас две лодки.	Махмæ ис дыууæ лодкæйы.
Том говорит мне, что у нас проблема.	Том мын загъта,проблемæтæ нын ис уый .
Я всё лето буду в Бостоне.	Æз æнæхъæн сæрд Бостоны уыдзынæн.
Ты не хочешь знать, почему я это сказал?	Нæ дæ фæнды зонын, цæмæ загътон афтæ уый ?
Он живёт беззаботно.	Нæмæт цард кæны.
Я хочу, чтобы ты отвёз меня обратно в Бостон.	Мæн фæнды цæмæй мæ Бостонмæ фæстæмæ аласай.
Тебе стоит с кем-нибудь поговорить.	Дæу хъæуы искæимæ аныхас кæнын.
Я знаю нескольких друзей Тома.	Æз зонын цалдæр Томы æмбалы.
Родители назвали ребёнка Акира.	Ныййырджытæ сывæрдтой сæ сывæллоныл Акира.
У меня есть веб-камера.	Мæнмæ ис веб-камерæ.
Стол длинный?	Стъол даргъ у?
Как вы научились танцевать?	Куыд сахуыр кодтай кафын?
Я никогда не хожу босиком.	Æз бæгъæввадæй никуы нæ фæцæуын.
Езжайте к вокзалу!	Вагзалмæ ацæут.
Что такое латынь?	Латынь цы у?
Ты мне сказал никому об этом не говорить.	Ды мын загътай цæмæй макæмæн дзурон уый тыххæй .
Побрейся.	Дæхи адас.
По-моему, так лучше.	Мæнмæ гæсгæ , афтæ хуыздæр у .
Мне нужно выучить японский язык.	Мæнæн хъæуы япойнаг æвзаг сахуыр кæнын.
У неё уйма книг.	Бирæ чингуытæ йæм ис.
Сколько риса ты ешь каждый день?	Цас хæрыс пырындз нæхъæн бон ?
Они летели.	Тæхгæ кодтой.
Ты это специально делаешь?	Ды барæй кæныс?
Том - портной.	Том хуыйæг у.
Сколько раз ты это сделала?	Цал хатты ай скодтай?
Волки - грозные хищники.	Бирæгътæ тасуадзæг тугдзыхтæ сты.
Текст готов для печати.	Текст цæдтæ у мыхуыр кæнынмæ.
Одно красное, а другое белое.	Иу дзы сырх уыди иннæ та урс.
А что, если она не права?	Мæ уæдтама раст у ?
Ты ещё куда-то хочешь поехать?	Фæнды ма дæ искуыдæм ацæуын?
Разве это не английская книга?	Ай англисаг чиныг нæу?
Ей тридцать один.	Æртын иу аз йыл цæуы.
Я опустил руки.	Æз мæ къухтæ ауахтон.
Я правду говорю, Том.	Æз раст дзурын , Том .
Он разговаривает во сне.	Уый фынæйæ дзургæ кæны.
Где твои внучки?	Кæм сты дæ фыртычызджытæ?
Мне очень нравится русский.	Æз тынг уарзын уырыссаг.
Том понимал.	Том хъуыды кодта.
Я получил билеты бесплатно.	Æз райстон билет лæварæй.
Кого же мне пригласить?	Кæй фæхонон?
Ты знаешь Риэ Миядзаву?	Ды зоныс Риэ Миядзавæйы?
Приходите на собрание.	Æрбацыт иу æмбырдмæ .
Вы тоже были в Бостоне?	Сымах дæр уыдыстут Бостоны?
Телефон перестал звонить.	Телефон нал дзуры .
Скажите ему, чтобы он ей помог.	Зæгъ ма цын, цæмæй йын аххуыс кæна.
Это очень трудная работа.	Тынг зын куыст у.
Как только он вернётся, сообщи мне.	Куыддæр фæстæмæ æрбаздæха, афта иу мын зæгъ.
У этой девочки голубые глаза.	Ацы чызгæн цъæх цæстытæ ис .
У Дженни есть пистолет.	Дженнимæ ис дамбаца .
Я тебя почти не слышу.	Зæгъæн ис мæ дæ нæ хъусын.
Хотите познакомиться с Томом?	Фæнды уæ Томимæ базонгæ кæнын?
Он вчера спал до десяти часов.	Знон дæс сахат мæ фынæй кодта.
Это правильно?	Ай раст у ?
Когда прочитаешь это письмо, сожги его.	Куы бакæсай ацы фыстæг , уæд иу æй басудз.
Пойдём в выходные на рыбалку?	Цом улæфæнбонты кæсаг ахсынмæ.
Я считаю Тома идиотом.	Æз нымайын Томы сæрхъæныл.
Я отправила их домой.	Хæдзармæ сæ арвыстон.
Кто ел?	Чи хордта?
Я слышал выстрел.	Æз фе’ хъуыстон æхст
На его месте должен был быть я.	Йæ бынаты хъуамæ æз уыдаин.
Как ты думаешь, сколько слов в этой книге?	Куыд хъуыды кæныс , ацы чиныгы цал ныхас ис ?
Погода действительно дрянь.	Боныгъæд цæгæй дæр æвзæр у .
Могу я пройти?	Мæ бон у ахизын?
Мужчина поднял руку, чтобы задать вопрос.	Нæлгоймаг йæ къухыл схæцыд , цæмæй фарста ратта.
Сколько вам пришлось ждать?	Цас уын бахъуыдис æнхъæлмæ кæсын?
Том не любит математику.	Том математикæ нæ уарзы.
Мы не напугались.	Мах нæ фæтарстыстæм.
Как думаешь, сколько ей?	Куыд хъуыды кæныс цал аз йыл цæуы?
Берите это.	Мæнæ ай райсут.
Ты испугаешься.	Ды фæтæрсдзынæ.
Том спал на скамейке в парке.	Том паркы фæхсбандоныл фынæй кодта.
Я знаю, что готов.	Æз зонын , цæттæ у .
Том продолжал смеяться.	Том дарддæр худтис .
Я должна победить.	Ӕз хъуамæ рамбулон.
А он доктор?	Дохтыр у?
Боб возвращается домой в шесть.	Боб хæдзармæ æрбацæуы æхсæз сахатыл.
Отец любит мать.	Фыд уарзы мады.
Сахар всегда сладкий.	Сæкæр алкæддæр адджын у.
Том снял парик.	Том парик раласта.
Когда стрелять?	Кæд хъæуы гæрах кæнын?
Уйдите оттуда.	Ацæут уырдыгæй.
Дай им войти.	Бауадз мæ бахизын.
Ты знаком с его братом?	Йе’фсымæримæ зонгæ дæ?
Я никогда не был богат.	Ӕз никуы нæ уыдтæн хъæздыг.
Том не смог бы сделать это в одиночку.	Томæн йæ бон не’суыдаит ай иунæгæй саразын.
Скажи это ещё раз.	Зæгъ ма йæ ноджыдар иу хатт.
Я кофе не пью.	Ӕз кофе нуазгæ нæ кæнын.
Это мой брат - Том.	Ай у ме’фсымæр -Том.
Я заплатила Тому.	Æз бафыстон Томæн.
Том покрасил волосы в зелёный цвет.	Том йæ сæр сахуырста кæрдæгхуызæй.
Иди сначала ты.	Фыццаг ды ацу.
Встретимся в пять.	Фе’мбæлæм фондз сахатыл.
Огонь был на первом этаже.	Арт фыццаг уæладзыгыл уыди.
Я спросил у неё адрес.	Бафарстон йын йæ адрис.
Не трать время попусту.	Рæстæг дзæгъæлы ма харц кæн.
Чего орёшь?	Цæуыл хъæр кæгыс?
Это только часть истории.	Ай нæма историйы хай у.
Я чувствую, что готова.	Æз æй хатын ,цæттæ дæн .
Не говорите так о моей семье.	Мæ бинонты тыххæй афтæ ма дзурут.
У тебя холодильник открыт.	Дæ уазалгæнæн гом у.
Том вышел из тюрьмы три года назад двадцатого октября.	Том рацыд ахæстонæй æртæ азы размæ ссæдзæм октябры.
Ладно, не переживай. Что-нибудь придумаем.	Ма тыхс , исты æрхъуыды кæндзыстæм.
У кого-нибудь есть фонарик?	Искæмæ фанар ис?
Почему Том ушёл от тебя?	Цæмæ дæ ныууагъта Том?
Я знал, что Том не победит.	Æз зыдтон, Том кæй нæ рамбулдзæн.
Я уже старая.	Ӕз зæронд дæн.
Трудно ли учить греческий язык?	Зын у грекаг æвзаг ахуыр кæнын?
Ты любишь гольф?	Гольф уарзыс?
Пока смерть не разлучит нас.	Цалынмæ нæ мæлæт нæ ахицæн кæна.
Я живу рядом с магазином.	Дуканийы цур цæрын .
"Спасибо". - "На здоровье".	"Бузныг". - "Табуафси".
Ты разве не адвокат?	Ӕвдакат нæ дæ?
Учись.	Ахуыр кæн.
Стой!	Фæлæу!
Морозно.	Хъызы.
Алло!	Алло!
Тепло.	Хъарм.
Учишься?	Ахуыр кæныс?
Достаточно!	Фаг у !
Довольно!	Æгъгъæд!
Конечно!	Уæдæ!
Молчать!	Дзыхыл хæцын!
Встаём.	Слæууыдыстæс.
Помогите!	Баххуыс кæнут !
Закрыто!	Хгæд у !
Увы.	Уæууау.
Полдесятого.	Дæсырдæг .
Нет!	Нæйы!
Поиграем?	Ахъазæм ?
Неужели?	Уанцон нæу?
Скорее!	Тагъддæр !
Чу!	Ацу !
Унесите.	Аххæсут.
Правильно!	Раст у !
Тихо!	Сабыргай!
Послушайте!	Байхъусут?
Сядь!	Æрбад!
Помолимся!	Акувæм !
Беги!	Лидз!
Серьёзно?	Уæгæй?
Пойдёшь?	Ацæудзынæ?
Поехали!	Ацыдыстæм !
Сюда.	Ардæм .
Уходим!	Ацыдыстæм !
Дурак!	Æдылы!
Обещаю.	Ныхас дæттын.
Выбирай.	Развар.
Исчезни!	Фесæф!
Болит?	Рисы?
Шутишь?	Хъынджылæг кæныс?
Поторопись!	Фæтагъд кæн !
Очнись.	Райхъал у .
Пора.	Афон у .
Присядемте.	Æрбадæм.
Отдыхаешь?	Улæфыс?
Садись.	Æрбад .
Врёшь!	Сайыс?
Прыгай!	Агæпп кæн !
Спасите!	Баххуыс кæнут !
Я помню, так что и ты не забывай.	Ыз æй хъуыды кæнын. мæ йæ ды дæр ма рох кæн
Нет, я на вас не сержусь, я просто огорчён.	На, ыз уа на ӕфхӕрӕн,
Том и Мэри не боятся.	Том æмæ Мэри нæ тæрсынч
Том уехал рано утром.	Том ацыди райсом раджы
У тебя уйма времени.	Дæу мæ бирæ рæстæг и
Я могу помочь Тому.	Мæ бон у бæххуыс кæнын Томæн
Том вытер руки о брюки.	Том йæ кухтæ йæ хæлафыл асæрфта
Не знаю, что меня так пугало.	Нæ йын зонын, афтæ тынг мæ цы тæрсын кодта
Ты читал, что там написано?	Бафарстай йæ цы дзы ис фыст?
Вы должны перед ними извиниться.	Сымах хъомæ хатыртæ ракурат
Кому задать этот вопрос?	Кæй бафарсон ацы фарст?
Вы на какой-то другой планете живёте?	Сымах æндæр планетæ цæрут?
Том не будет знать, кому это отдать.	Томæй нæ зодзæни кæмæн йæ хъомæ раттæ
Том любит петь?	Том уарзы зарын?
Вы слушали?	Сымах хъуыстат?
Прости, что вчера на вас наорал.	Хатыр, знон дыл кæй ныхъхъæр кодтон
Это слово есть в любом словаре.	Ацы ныхас ис алкæцы чиныгы дæр
Давай больше никогда не будем об этом говорить.	Æри макуыал дзурæм ауыл
Элен вышла на следующей остановке.	Элен рахызт иннæ остановкæйыл
Сколько за одного человека?	Цас у иу адæймаган?
Я просто не могу поверить в это.	Нæ мæ уырны
Я пытался помочь Тому, но не мог.	Фæлварын Томæн баххуыс кæнын, фæлæ нæу мæ бон
Он должен быть сделан.	Уый хъомæ уæ арыст
Я хотел бы её увидеть.	Ман фӕнды уийы фенын
Потолок покрашен в жёлтый цвет.	Цар ахуырст у бур хузæй
Я очень люблю свою мать.	Ыз тынг уарзын мæ мады
У тебя есть швейная машинка?	Хуыйгæнаг машинæ дæм ис?
Ну почему ты мне не веришь?	Цӕмӕнна мыл ’ууӕндыс?
Это хорошая работа.	Айæ у хорз куыст
Она не хочет, чтобы я говорил на эту тему.	Уийы нæ фæнды, цæмæй уцы темæйл дзурон
Снимай обувь.	Ралас къахыдарæс
Том отправил Мэри текстовое сообщение.	Том арвыста Мэрийан ног хабæрттæ
Мэри заработала много денег.	Мэри бирæ ӕхца бакуыста
Вы знакомы?	Зонгæ стут?
Мне надо было остаться дома.	Хæдзары мын хъуыдис æрллауын.
Они встретятся с Лвизой завтра.	Лвизæимæ сом фембæлдзысты.
Я солгал, когда он спросил, сколько мне лет.	Æз фæсайдтон, куы мæ бафарстат, цал азы мыл цæуы уæд.
Поживи пока у меня, а там что-нибудь придумаем.	Ме’мæ уал цæр , мæ стæй исты æрхъуыды кæндзыстæм.
Он местный чокнутый.	Бынæттон æдылы у.
Я видела, как Том умирает.	Æз феттон , Том куыд мардис уый.
Том - патриот.	Том-патриот у .
Я не говорю, что она поступила правильно.	Æз нæ дзурын, раст кæй бакодта уый .
Я самая младшая из трёх сестёр.	Æртæ хойы, æз кæстæр дæн.
Кто еще придёт на вечеринку?	Чи ма æрбацæудзæн хъазтизæрмæ?
"Как жизнь, Том?" - "Хуже некуда".	«Куыд у цард , Том ?»-«æвзæрдæр никуыдæм»
Просто отдай приказ.	Бардзырд ратт.
Флаг Бразилии зелёный, жёлтый и синий.	Бразилийы тырыса , кæрдæгхуыз бур æмæ арвхуыз.
Я просто думаю, что это смешно.	Æз хъуыды кæнын, худæг кæй у .
Том сказал, что он в Бостоне.	Том загъта, Бостоны дам дæн.
Не снимай обувь.	Дзабыртæ ма ралас.
Том не хочет ехать с вами.	Томы нæ фæнды сымахимæ цæуый.
Теперь там музей.	Ныртæккæ та дзы ис музей.
У меня пошла кровь.	Туг мæ рацыдис.
Скажите Тому, что его зонт до сих пор у меня.	Зæгъут Томæн , йæ зонт нæма дæр мæнмæ ис .
Отец ничего не говорит.	Мæ фыд ницы дзуры.
Это твой сыновний долг.	Ай фырты хæс у .
Как ты можешь шутить в такой ситуации?	Дæ бон куыд у ахæм хабары хъынджылæг кæнын?
У меня в Бостоне брат живёт.	Мæнæн Бостоны ме’фсымæр цæры.
Мэри засмеялась, увидев Тома голым.	Мэри ныххудтис, Том куы федта гомæй уæд .
Мне нравятся люди, которые не боятся стареть.	Мæнæн мæ зæрдæмæ цæуынц ахæм адæм , кæдон нæ тæрсынц зæронд кæнын.
Я часто говорю с Томом.	Æз арæх дзурын Томимæ.
Том не сделал того, что от него ожидали.	Том нæ сарæзта, цы дзы нхъæлдтой уый.
Меня проводили до моего места.	Мæ бынатмæ мæ ахизын кодтой.
Думаю, вы можете помочь им.	Хъуыды кæнын, сымахæн уæ бон суыдзæним уыдонæн баххуыс кæнын.
Я неплохо его знал.	Æз æй æвзæр нæ зонын.
Думаю, у нас проблемы.	Хъуыды кæнын, проблемæтæ нын ис .
Я пенсионерка.	Æз пенсионеркæ дæн .
Я уже была здесь.	Æз уыдтæн ам.
Это должно быть смешно?	Худæг хъуамæ уа?
Я люблю смотреть футбольные матчи.	Æз уарзын къахпортийы матчмæ кæсын.
Мне очень понравилась эта книга!	Мæ зæрдæмæ тынг фæцыд ацы чиныг!
Я бы с тобой согласился, но тогда мы бы оба ошибались.	Æз де’ма сразы уыдаин , фæлæ уæд нæ дыууæ дæр рæдыдаиккам.
Кен ходил на костылях.	Кен цыдис æнцойгæнæн лæдзæгимæ.
Нас выгнали.	Мах расырдтой.
Каждого мальчика и девочку учат читать и писать.	Алкæцы чызг æмæ лæппуйы ахуыр кæнынц кæсын æмæ фыссын .
Мне нужно, чтобы вы помогли мне это найти.	Мæн фæнды, цæмæй мын сымах баххуыс кæнат уый ссарын .
Я не могу пойти одна.	Мæ бон нæу иунæгæй ацæуын.
Мне нужно, чтобы кто-нибудь помог мне разбогатеть.	Мæн фæнды, цæмæй мын исчи баххуыс цæмæй схъæздыг уон .
Том сказал, что он не расстроен.	Том загъта , мæстджын нæу.
Сегодня вечером я буду заниматься.	Абон изæрæй æз архайдзынæн .
Мало того, что ты мне жизнь испортил, ты ещё и ей хочешь испортить?	Фаг дын нæ уыдис мæ цырд мын кæй фехæлдтай, мæ ма йæ уымæн дæр хъуамæ фехалай?
Найти Тому замену?	Ссарын Томæн ивддзаг?
Мы всё купили.	Мах алцыдæр балхæдтам.
Иди постучи в дверь Тома.	Ицу бахой Томы дуармæ .
Ты выйдешь замуж.	Ды ацæудзынæ чындзы.
Том раньше работал с Мэри.	Том раздæр куыста Мэриимæ.
На каждой стене – зеркало.	Алкæцы къулыл дæр - кæсæн.
Где мы встречаемся?	Кæм фембæлдзыстæм?
Вы можете сказать мне, что у вас есть?	Уæ бон у мæ мын зæгъат, цы уæм ис ?
За это можно не платить?	Ай тыххæй гæнæн ис ма бафидын?
Ты был прав. Том - полный идиот.	Ды раст уыдтæ. Том -сæрхъæн у .
Он в розыске.	Агуырды ис .
Давай начнём полтретьего.	Цæйут райдайæм æртæйы рдæгыл.
Вместе мы сможем с этим справиться.	Иумæ махæн нæ бон суыдзæнис сарæхсын.
Я сказал Тому, что мы едем на несколько дней в Австралию.	Æз загътон Томæн , мах кæй цæуæм цалдæр бон мæ Австралимæ.
В этом никто не сомневался.	Уым ничи гуырысхо кодта.
Почему ты в моих ботинках?	Цæмæ дæ мæ дзабырты?
Ты знаешь, что стало с Томом?	Ды зоныс , Томимæ цы рцыд?
Как ты думаешь, откуда Том об этом узнал?	Куды хъуыды кæныс, кæцæй баззыдта Том уый тыххæй?
Почему вы не помогли ей сбежать?	Цæмæнæ йын баххуыс кодтат алидзын?
Кто сюда поставил фикус? Здесь его обязательно сломают.	Ам чи сывæрдта фикус? Ам æй æнæмæнг ацъæл кæндзысты.
Я готова. А Вы?	Æз цæттæ дæн. Сымах та ?
Сначала казалось, что у Тома всё хорошо.	Фыццаг афта кастис, мæ Томæн алцы дæр хорз у .
Том живёт с отцом в Бостоне.	Том йæ фыдимæ цæры Бостоны .
Что ты принёс?	Цы æрбахастай?
Почему он ему этого не говорит?	Цæмæнæ мын æй дзуры?
Не ожидал от вас такого.	Сымахæй ахæм нхъæл нæ уыдтæн.
Том хотел знать, что происходит.	Томы фæндыд зонын, цы тæ цæуы уыдон.
Дописывайте и сдавайте работы.	Фыст фæут æмæ радæттут уæ куыстытæ.
Это мои коты.	Адон мæ гæдытæ сты.
Я сказал Тому, в чём заключается проблема.	Æз загътон Томæн , проблемæ цæй мидæг ис .
Когда ты закончил работу?	Кæд фæдæ куыст ?
В последнее время вы делаете слишком много ошибок.	Фæстаг рæстæджы тынг бирæ рæдийут.
Поедем в больницу.	Ацæуæм рынчындонмæ.
Что бы Том без меня делал?	Том цы кодтаит æнæ мæнæй?
А что, если их нет дома?	Уæдта ма хæдзары не’сты?
Она поёт прекрасную песню.	Уый зары диссаджы зарæг.
Мэри сказала Тому, что они должны уехать.	Мэри загъта Томæн, ацæуын сæ кæй хъæуы уый .
Если это вопрос, каков же тогда ответ?	Кæд ай фарста у , уæд дзы цавæр дзуапп хъуамæ уа?
Том ещё плохо знал женщин.	Том нæма æвзæр зыдта сылгоймæгты.
Он свою работу сваливает на другого.	Уый йæ куыст иннæтæм калы.
Я действительно скучаю по жене.	Æз æцæгæй дæр мысын мæ усы.
"Кого ты любишь?" - "Мэри".	«Кæй уырзыс?»-«Мэри».
Мы с Томом скоро будем соседями.	Томимæ тагъд сыхæгтæ уыдзыстæм .
Никогда об этом не слышал.	Никуы фе’хъуыстон уый тыххæй.
В результате Том не пришёл.	Йæ фæстиуагы Том не’рбацыдис.
Хорошо, я с ним поговорю.	Хорз , æз йе’мæ аныхас кæндзынæн.
Не отдавай его.	Ма йæ ратт.
Когда мама болела, я заботился о ней.	Нана рынчын куы уыдис, уæд йæм мæ хъус дарттон .
Осторожнее, не обожгись.	Сабыргай, ма басудз.
Позвони мне после того, как поговоришь с Томом.	Фæдзур иу мæм Томимæ куы аныхас кæнай уæд.
Все фрукты испортились.	Дыргътæ иууылдæр нал бæззынц .
Покажи мне свою тетрадь, пожалуйста.	Дæ тетрад ма мын равдис, дæ хорзæхæй.
Машина!	Машинæ!
Начнём.	Райдайæм.
Жаль...	Хъыг у .
Дудки!	Уадындзтæ!
Давай!	Цæй!
Помилуйте!	Ныххатыр кæнут!
Выпьем?	Бануазæм ?
Волнуешься?	Тыхсыс?
Занято.	Ахст у.
Болван!	Гуымыдза!
Исчезни.	Фесæф .
Начинай!	Райдай!
Догоняешь?	Райафыс?
Никак.	Никуыд.
Просыпайся!	Райхъал у!
Сожалею.	Фæсмон кæнын.
Поехали.	Ацыдыстæм.
Откуда?	Кæцæй?
Помолчи!	Банцай?
Кругом!	Алварс!
Ерунда.	Ницæйаг.
Забудьте!	Ферох кæнут!
Темнеет.	Талынг кæны.
Огонь!	Арт!
Кто?	Чи?
Подожди!	Фæлæу!
Боишься?	Тæрсыс?
Входите.	Рбахизут.
Поняла!	Бамбæрстон!
Познакомьтесь.	Базонгæут.
Предатель.	Уæйгæнæг.
Притормози!	Фæуром!